TGTAATCCCTTGACAAAATT -> GTAATCCCTTGACAAAATTG
ATCCTGATTGGGCGAAGAAC -> TCCTGATTGGGCGAAGAACG
ACCGTTACTGAAACAGTTAT -> CCGTTACTGAAACAGTTATG
CCGCGCGCGCGCCAGTCCGC -> CGCGCGCGCGCCAGTCCGCC
GGTCCATTGAAAGGGGCACT -> GTCCATTGAAAGGGGCACTT
CTAGGCTCGGGTTCTCCGTT -> TAGGCTCGGGTTCTCCGTTG
TTTTCAGGCGGGCGTCCAGG -> TTTCAGGCGGGCGTCCAGGT
TTGGGGTGCGAAGTGAGCGG -> TGGGGTGCGAAGTGAGCGGT
AAGTGAGCGGTGCTGATCAG -> AGTGAGCGGTGCTGATCAGT
TCGACTAGAGCTTCTACAGG -> CGACTAGAGCTTCTACAGGC
CATGTTGCGCCCTTAGGGCG -> ATGTTGCGCCCTTAGGGCGC
CAGTCCGCCCAACATATTCA -> AGTCCGCCCAACATATTCAT
AAAACAGTGCGGGAAAAGTT -> AAACAGTGCGGGAAAAGTTG
TACCACCGTTACTGAAACAG -> ACCACCGTTACTGAAACAGT
CTAGGTCAACTAACACCCTG -> TAGGTCAACTAACACCCTGG
CATTGAAAGGGGCACTTCCT -> ATTGAAAGGGGCACTTCCTA
TGTTAACGGGTTCAATACAG -> GTTAACGGGTTCAATACAGA
GGTCAACTAACACCCTGGTC -> GTCAACTAACACCCTGGTCT
TCCATTGAAAGGGGCACTTC -> CCATTGAAAGGGGCACTTCC
CCGGGGTCGTTACGGATAAA -> CGGGGTCGTTACGGATAAAA
CGCCCAACATATTCATTCAG -> GCCCAACATATTCATTCAGC
CTCGAAGCTTCTTAGGATAA -> TCGAAGCTTCTTAGGATAAC
GAAACAGTTATGTCGCAGGC -> AAACAGTTATGTCGCAGGCG
TGGACCCTAGTGTCTGAACA -> GGACCCTAGTGTCTGAACAG
GGGTGCGAAGTGAGCGGTGC -> GGTGCGAAGTGAGCGGTGCT
TGATTGGGCGAAGAACGCCC -> GATTGGGCGAAGAACGCCCT
CGGTGCTGATCAGTGATTGT -> GGTGCTGATCAGTGATTGTA
ACCCTAGTGTCTGAACAGCC -> CCCTAGTGTCTGAACAGCCG
CGTCTGTTAACGGGTTCAAT -> GTCTGTTAACGGGTTCAATA
TAAGCAGCCGTGCAGTTCTC -> AAGCAGCCGTGCAGTTCTCG
CTTAAGACTGACTCATCCCC -> TTAAGACTGACTCATCCCCA
GAGGGCTGGTTAAAGAGACG -> AGGGCTGGTTAAAGAGACGT
CTAATTGACTCTATCTTCCT -> TAATTGACTCTATCTTCCTA
GTAATGTGGTTGCGTTAAGT -> TAATGTGGTTGCGTTAAGTA
ACTAACACCCTGGTCTGGTA -> CTAACACCCTGGTCTGGTAT
GGTGCGAAGTGAGCGGTGCT -> GTGCGAAGTGAGCGGTGCTG
CCACGTTCAGACTCTGCAAC -> CACGTTCAGACTCTGCAACG
AAAAGAGGGATACTGCCGCA -> AAAGAGGGATACTGCCGCAT
CGTTAAGTAGTCGAAACCCA -> GTTAAGTAGTCGAAACCCAA
AGCAGCCGTGCAGTTCTCGC -> GCAGCCGTGCAGTTCTCGCA
ACCCAACAATGCAAACAACT -> CCCAACAATGCAAACAACTC
ACGTGATCAACTGTAGGCTG -> CGTGATCAACTGTAGGCTGG
TAAGTAGTCGAAACCCAACA -> AAGTAGTCGAAACCCAACAA
AGAGGGCTGGTTAAAGAGAC -> GAGGGCTGGTTAAAGAGACG
TTGCGCCCTTAGGGCGCCAA -> TGCGCCCTTAGGGCGCCAAC
GATACTGCCGCATCTAGGTC -> ATACTGCCGCATCTAGGTCA
TGAACATCACTCTTACGAAG -> GAACATCACTCTTACGAAGA
GGTTCAATACAGACATGTTG -> GTTCAATACAGACATGTTGC
TCAGCGACCACGTTCAGACT -> CAGCGACCACGTTCAGACTC
TGTGTTTTACCTCACTTCGG -> GTGTTTTACCTCACTTCGGA
GAGCAGAGGGCTGGTTAAAG -> AGCAGAGGGCTGGTTAAAGA
GCAGTTCTCGCAGAATCTAT -> CAGTTCTCGCAGAATCTATC
TCTGGTATCCTGATTGGGCG -> CTGGTATCCTGATTGGGCGA
GAACAGCCGCGCGCGCGCCA -> AACAGCCGCGCGCGCGCCAG
CCTCACTTCGGATTGTCACT -> CTCACTTCGGATTGTCACTT
TGTGGTTGCGTTAAGTAGTC -> GTGGTTGCGTTAAGTAGTCG
TAAAGAGACGTTAGACCTGT -> AAAGAGACGTTAGACCTGTA
GGCACGAAAACAGTGCGGGA -> GCACGAAAACAGTGCGGGAA
TTTAAGCAGCCGTGCAGTTC -> TTAAGCAGCCGTGCAGTTCT
CGCCCGAGCTCCCTCAACTT -> GCCCGAGCTCCCTCAACTTA
CAACAGAGTCCGATTCGGGA -> AACAGAGTCCGATTCGGGAC
ATCAGTGATTGTAATCCCTT -> TCAGTGATTGTAATCCCTTG
GAAGAGTGTACGCATCGCCG -> AAGAGTGTACGCATCGCCGG
AAAATTGTTGATGCTCGAAG -> AAATTGTTGATGCTCGAAGC
GGTCGTTACGGATAAAAAAA -> GTCGTTACGGATAAAAAAAA
GACCCAATGCAGATAATCAT -> ACCCAATGCAGATAATCATA
CAGCTTCTAACCTAGCCAAC -> AGCTTCTAACCTAGCCAACG
GGACCCTAGTGTCTGAACAG -> GACCCTAGTGTCTGAACAGC
CGGTGTACTCCTCGCTCCCT -> GGTGTACTCCTCGCTCCCTA
TTGGGCGAAGAACGCCCTAC -> TGGGCGAAGAACGCCCTACC
CTAGCCAACGTGATCAACTG -> TAGCCAACGTGATCAACTGT
CCTCGCTCCCTAGCCACTGG -> CTCGCTCCCTAGCCACTGGG
GGTATATTGCGTTTGAGAGC -> GTATATTGCGTTTGAGAGCA
AAGAGTAATGTGGTTGCGTT -> AGAGTAATGTGGTTGCGTTA
TCAGTGATTGTAATCCCTTG -> CAGTGATTGTAATCCCTTGA
AATTGACTCTATCTTCCTAC -> ATTGACTCTATCTTCCTACA
TTTGAGCTAGGCTCGGGTTC -> TTGAGCTAGGCTCGGGTTCT
TATATGGTTGAAGTATCGGG -> ATATGGTTGAAGTATCGGGG
AACACCCTGGTCTGGTATCC -> ACACCCTGGTCTGGTATCCT
CTTAGGATAACTCGGTCCAT -> TTAGGATAACTCGGTCCATT
TGGGCGAAGAACGCCCTACC -> GGGCGAAGAACGCCCTACCA
CCAGACCCAATGCAGATAAT -> CAGACCCAATGCAGATAATC
ATCATCGTGTGTTTTACCTC -> TCATCGTGTGTTTTACCTCA
GCGACCACGTTCAGACTCTG -> CGACCACGTTCAGACTCTGC
AATCTGTAATATGGCACGAA -> ATCTGTAATATGGCACGAAA
AAGCTTCTTAGGATAACTCG -> AGCTTCTTAGGATAACTCGG
ACTCTATCTTCCTACATTTT -> CTCTATCTTCCTACATTTTT
TCGGGTTCTCCGTTGAACAT -> CGGGTTCTCCGTTGAACATC
AACAGGCTACCTCCGTTTAA -> ACAGGCTACCTCCGTTTAAG
CGAAACAGGCTACCTCCGTT -> GAAACAGGCTACCTCCGTTT
TGTTTTACCTCACTTCGGAT -> GTTTTACCTCACTTCGGATT
TGACAAAATTGTTGATGCTC -> GACAAAATTGTTGATGCTCG
TGACAACAGAGTCCGATTCG -> GACAACAGAGTCCGATTCGG
CGTAAATCTGTAATATGGCA -> GTAAATCTGTAATATGGCAC
TACGGATAAAAAAAACGATG -> ACGGATAAAAAAAACGATGG
GGATAACTCGGTCCATTGAA -> GATAACTCGGTCCATTGAAA
AAGAGACGTTAGACCTGTAT -> AGAGACGTTAGACCTGTATC
CACGAAAACAGTGCGGGAAA -> ACGAAAACAGTGCGGGAAAA
TAGGCTCGGGTTCTCCGTTG -> AGGCTCGGGTTCTCCGTTGA
GGGGGTAACGTCAAGCGTCT -> GGGGTAACGTCAAGCGTCTG
CACGTTCAGACTCTGCAACG -> ACGTTCAGACTCTGCAACGC
TCTCGCAGAATCTATCACTC -> CTCGCAGAATCTATCACTCT
TTGCGAGGGGGGTAACGTCA -> TGCGAGGGGGGTAACGTCAA
TTGAACATCACTCTTACGAA -> TGAACATCACTCTTACGAAG
TTCTACAGGCTTATGACAAC -> TCTACAGGCTTATGACAACA
TAATCATAACGCGGCTTCTC -> AATCATAACGCGGCTTCTCG
TGCCGCATCTAGGTCAACTA -> GCCGCATCTAGGTCAACTAA
TCAATACAGACATGTTGCGC -> CAATACAGACATGTTGCGCC
ACCCAATGCAGATAATCATA -> CCCAATGCAGATAATCATAA
GGCGGGCGTCCAGGTATATT -> GCGGGCGTCCAGGTATATTG
CCTAGCCAACGTGATCAACT -> CTAGCCAACGTGATCAACTG
CAAGCGTCTGTTAACGGGTT -> AAGCGTCTGTTAACGGGTTC
GTGGTTGCGTTAAGTAGTCG -> TGGTTGCGTTAAGTAGTCGA
TCAAGCGTCTGTTAACGGGT -> CAAGCGTCTGTTAACGGGTT
TCGTGTGTTTTACCTCACTT -> CGTGTGTTTTACCTCACTTC
TTAACGGGTTCAATACAGAC -> TAACGGGTTCAATACAGACA
TCATTCAGCGACCACGTTCA -> CATTCAGCGACCACGTTCAG
CGTTCAGACTCTGCAACGCA -> GTTCAGACTCTGCAACGCAG
ACAGAGTCCGATTCGGGACC -> CAGAGTCCGATTCGGGACCC
GGCGTCCAGGTATATTGCGT -> GCGTCCAGGTATATTGCGTT
GTATCATCGTGTGTTTTACC -> TATCATCGTGTGTTTTACCT
GACTGACTCATCCCCAGCTT -> ACTGACTCATCCCCAGCTTC
CTTCCTACATTTTTTCAGGC -> TTCCTACATTTTTTCAGGCG
AATGTGGTTGCGTTAAGTAG -> ATGTGGTTGCGTTAAGTAGT
GTCGTTACGGATAAAAAAAA -> TCGTTACGGATAAAAAAAAC
AGCCAACGTGATCAACTGTA -> GCCAACGTGATCAACTGTAG
CGGTCCATTGAAAGGGGCAC -> GGTCCATTGAAAGGGGCACT
CCCAACAATGCAAACAACTC -> CCAACAATGCAAACAACTCG
AGGTATATTGCGTTTGAGAG -> GGTATATTGCGTTTGAGAGC
CGTGTGTTTTACCTCACTTC -> GTGTGTTTTACCTCACTTCG
AACGGGTTCAATACAGACAT -> ACGGGTTCAATACAGACATG
GGGTCGTTACGGATAAAAAA -> GGTCGTTACGGATAAAAAAA
GAGCTAGGCTCGGGTTCTCC -> AGCTAGGCTCGGGTTCTCCG
GTGCAGTTCTCGCAGAATCT -> TGCAGTTCTCGCAGAATCTA
ATAACTCGGTCCATTGAAAG -> TAACTCGGTCCATTGAAAGG
CAACTGGACACCTCGACTAG -> AACTGGACACCTCGACTAGA
AGACTGACTCATCCCCAGCT -> GACTGACTCATCCCCAGCTT
GTGATTGTAATCCCTTGACA -> TGATTGTAATCCCTTGACAA
ATAATCATAACGCGGCTTCT -> TAATCATAACGCGGCTTCTC
GGCTACCTCCGTTTAAGCAG -> GCTACCTCCGTTTAAGCAGC
TTTTGAGCTAGGCTCGGGTT -> TTTGAGCTAGGCTCGGGTTC
TCCCTAGCCACTGGGATCCC -> CCCTAGCCACTGGGATCCCC
CTCCGTTGAACATCACTCTT -> TCCGTTGAACATCACTCTTA
ACCACCGTTACTGAAACAGT -> CCACCGTTACTGAAACAGTT
AAAAAAAACGATGGAGTCCA -> AAAAAAACGATGGAGTCCAG
GACCACGTTCAGACTCTGCA -> ACCACGTTCAGACTCTGCAA
TACTGAAACAGTTATGTCGC -> ACTGAAACAGTTATGTCGCA
AAAACGATGGAGTCCAGACC -> AAACGATGGAGTCCAGACCC
CCTGGTCTGGTATCCTGATT -> CTGGTCTGGTATCCTGATTG
TGTAGGCTGGACCCTAGTGT -> GTAGGCTGGACCCTAGTGTC
CAGATAATCATAACGCGGCT -> AGATAATCATAACGCGGCTT
CCTTAGGGCGCCAACTGGAC -> CTTAGGGCGCCAACTGGACA
CGCCCTTAGGGCGCCAACTG -> GCCCTTAGGGCGCCAACTGG
ATGTGGTTGCGTTAAGTAGT -> TGTGGTTGCGTTAAGTAGTC
CGTCCAGGTATATTGCGTTT -> GTCCAGGTATATTGCGTTTG
ACAGGCTTATGACAACAGAG -> CAGGCTTATGACAACAGAGT
GGGAAGAGTGTACGCATCGC -> GGAAGAGTGTACGCATCGCC
GCTGATCAGTGATTGTAATC -> CTGATCAGTGATTGTAATCC
AACAGCCGCGCGCGCGCCAG -> ACAGCCGCGCGCGCGCCAGT
TGAGAGCAGAGGGCTGGTTA -> GAGAGCAGAGGGCTGGTTAA
CCCCGTCTGAAAAGAGGGAT -> CCCGTCTGAAAAGAGGGATA
AGTGTACGCATCGCCGGGGT -> GTGTACGCATCGCCGGGGTC
CTTGGGGTGCGAAGTGAGCG -> TTGGGGTGCGAAGTGAGCGG
TACTGCCGCATCTAGGTCAA -> ACTGCCGCATCTAGGTCAAC
GTCAAGCGTCTGTTAACGGG -> TCAAGCGTCTGTTAACGGGT
CGGGAAAAGTTGCGAGGGGG -> GGGAAAAGTTGCGAGGGGGG
GCAACGCAGTGCTGCTAATT -> CAACGCAGTGCTGCTAATTG
CTTCTTAGGATAACTCGGTC -> TTCTTAGGATAACTCGGTCC
CTGACTCATCCCCAGCTTCT -> TGACTCATCCCCAGCTTCTA
ACTTCCTAGTATATGGTTGA -> CTTCCTAGTATATGGTTGAA
CTCGCCCGAGCTCCCTCAAC -> TCGCCCGAGCTCCCTCAACT
AAACAGGCTACCTCCGTTTA -> AACAGGCTACCTCCGTTTAA
GCGGGCGTCCAGGTATATTG -> CGGGCGTCCAGGTATATTGC
CAACGTGATCAACTGTAGGC -> AACGTGATCAACTGTAGGCT
CTATCACTCTTCCACTTGGG -> TATCACTCTTCCACTTGGGG
CCTCGACTAGAGCTTCTACA -> CTCGACTAGAGCTTCTACAG
GATGGAGTCCAGACCCAATG -> ATGGAGTCCAGACCCAATGC
AACTCGGTCCATTGAAAGGG -> ACTCGGTCCATTGAAAGGGG
CTAGCCACTGGGATCCCCGT -> TAGCCACTGGGATCCCCGTC
GTTATGTCGCAGGCGTAAAT -> TTATGTCGCAGGCGTAAATC
CACTCTTACGAAGATTTATC -> ACTCTTACGAAGATTTATCT
ATCTGTAATATGGCACGAAA -> TCTGTAATATGGCACGAAAA
ACCTGTATCATCGTGTGTTT -> CCTGTATCATCGTGTGTTTT
CCCTGGTCTGGTATCCTGAT -> CCTGGTCTGGTATCCTGATT
GGAAAAGTTGCGAGGGGGGT -> GAAAAGTTGCGAGGGGGGTA
ATTGTCACTTTTGAGCTAGG -> TTGTCACTTTTGAGCTAGGC
CCACTTGGGGTGCGAAGTGA -> CACTTGGGGTGCGAAGTGAG
GACCTGTATCATCGTGTGTT -> ACCTGTATCATCGTGTGTTT
GTGATCAACTGTAGGCTGGA -> TGATCAACTGTAGGCTGGAC
GCCTTACGGTGTACTCCTCG -> CCTTACGGTGTACTCCTCGC
GATTGGGCGAAGAACGCCCT -> ATTGGGCGAAGAACGCCCTA
CAAAATTGTTGATGCTCGAA -> AAAATTGTTGATGCTCGAAG
TGGTTGAAGTATCGGGGAAG -> GGTTGAAGTATCGGGGAAGA
TGGCACGAAAACAGTGCGGG -> GGCACGAAAACAGTGCGGGA
TGAACAGCCGCGCGCGCGCC -> GAACAGCCGCGCGCGCGCCA
AACAACTCGAAACAGGCTAC -> ACAACTCGAAACAGGCTACC
GGCTGGTTAAAGAGACGTTA -> GCTGGTTAAAGAGACGTTAG
ACGGATAAAAAAAACGATGG -> CGGATAAAAAAAACGATGGA
AACAATGCAAACAACTCGAA -> ACAATGCAAACAACTCGAAA
CCGAGCTCCCTCAACTTAAG -> CGAGCTCCCTCAACTTAAGA
TCCCCAGCTTCTAACCTAGC -> CCCCAGCTTCTAACCTAGCC
GTCTGGTATCCTGATTGGGC -> TCTGGTATCCTGATTGGGCG
TCCGTTTAAGCAGCCGTGCA -> CCGTTTAAGCAGCCGTGCAG
CCGTTTAAGCAGCCGTGCAG -> CGTTTAAGCAGCCGTGCAGT
CGCGCGCCAGTCCGCCCAAC -> GCGCGCCAGTCCGCCCAACA
AAACAGTTATGTCGCAGGCG -> AACAGTTATGTCGCAGGCGT
GGGTTCTCCGTTGAACATCA -> GGTTCTCCGTTGAACATCAC
ACTTAAGACTGACTCATCCC -> CTTAAGACTGACTCATCCCC
CGAAACCCAACAATGCAAAC -> GAAACCCAACAATGCAAACA
TCCTCGCTCCCTAGCCACTG -> CCTCGCTCCCTAGCCACTGG
GTAGGCTGGACCCTAGTGTC -> TAGGCTGGACCCTAGTGTCT
AGAATCTATCACTCTTCCAC -> GAATCTATCACTCTTCCACT
ACGTTCAGACTCTGCAACGC -> CGTTCAGACTCTGCAACGCA
AGGATAACTCGGTCCATTGA -> GGATAACTCGGTCCATTGAA
AGCTCCCTCAACTTAAGACT -> GCTCCCTCAACTTAAGACTG
GCCGCATCTAGGTCAACTAA -> CCGCATCTAGGTCAACTAAC
TTTACCTCACTTCGGATTGT -> TTACCTCACTTCGGATTGTC
AATCTATCACTCTTCCACTT -> ATCTATCACTCTTCCACTTG
ACGCAGTGCTGCTAATTGAC -> CGCAGTGCTGCTAATTGACT
AAGTATCGGGGAAGAGTGTA -> AGTATCGGGGAAGAGTGTAC
CAACTCGAAACAGGCTACCT -> AACTCGAAACAGGCTACCTC
CCCTAGCCACTGGGATCCCC -> CCTAGCCACTGGGATCCCCG
AGTGCGGGAAAAGTTGCGAG -> GTGCGGGAAAAGTTGCGAGG
GCTTCTACAGGCTTATGACA -> CTTCTACAGGCTTATGACAA
GTATATTGCGTTTGAGAGCA -> TATATTGCGTTTGAGAGCAG
AGTCGAAACCCAACAATGCA -> GTCGAAACCCAACAATGCAA
GCAGAATCTATCACTCTTCC -> CAGAATCTATCACTCTTCCA
CGCGGCTTCTCGCCTTACGG -> GCGGCTTCTCGCCTTACGGT
GGGCACTTCCTAGTATATGG -> GGCACTTCCTAGTATATGGT
GTCCAGACCCAATGCAGATA -> TCCAGACCCAATGCAGATAA
TTCTAACCTAGCCAACGTGA -> TCTAACCTAGCCAACGTGAT
GTAAATCTGTAATATGGCAC -> TAAATCTGTAATATGGCACG
GAAACCCAACAATGCAAACA -> AAACCCAACAATGCAAACAA
TCGAAACAGGCTACCTCCGT -> CGAAACAGGCTACCTCCGTT
GTCCGATTCGGGACCCTCGC -> TCCGATTCGGGACCCTCGCC
TGTATCATCGTGTGTTTTAC -> GTATCATCGTGTGTTTTACC
AACATCACTCTTACGAAGAT -> ACATCACTCTTACGAAGATT
CGAGCTCCCTCAACTTAAGA -> GAGCTCCCTCAACTTAAGAC
CTGGGATCCCCGTCTGAAAA -> TGGGATCCCCGTCTGAAAAG
TTCATTCAGCGACCACGTTC -> TCATTCAGCGACCACGTTCA
CTCCCTCAACTTAAGACTGA -> TCCCTCAACTTAAGACTGAC
AACGCCCTACCACCGTTACT -> ACGCCCTACCACCGTTACTG
CGTCTGAAAAGAGGGATACT -> GTCTGAAAAGAGGGATACTG
GGGGCACTTCCTAGTATATG -> GGGCACTTCCTAGTATATGG
AGGGGCACTTCCTAGTATAT -> GGGGCACTTCCTAGTATATG
CGAAGCTTCTTAGGATAACT -> GAAGCTTCTTAGGATAACTC
GTATCGGGGAAGAGTGTACG -> TATCGGGGAAGAGTGTACGC
CAGACTCTGCAACGCAGTGC -> AGACTCTGCAACGCAGTGCT
ATTCATTCAGCGACCACGTT -> TTCATTCAGCGACCACGTTC
TACTCCTCGCTCCCTAGCCA -> ACTCCTCGCTCCCTAGCCAC
TACCTCCGTTTAAGCAGCCG -> ACCTCCGTTTAAGCAGCCGT
AGGGATACTGCCGCATCTAG -> GGGATACTGCCGCATCTAGG
GTTGAACATCACTCTTACGA -> TTGAACATCACTCTTACGAA
ATGGCACGAAAACAGTGCGG -> TGGCACGAAAACAGTGCGGG
GTTTAAGCAGCCGTGCAGTT -> TTTAAGCAGCCGTGCAGTTC
TGGTTAAAGAGACGTTAGAC -> GGTTAAAGAGACGTTAGACC
ACATGTTGCGCCCTTAGGGC -> CATGTTGCGCCCTTAGGGCG
TAGCCACTGGGATCCCCGTC -> AGCCACTGGGATCCCCGTCT
ACCTAGCCAACGTGATCAAC -> CCTAGCCAACGTGATCAACT
GGGCGTCCAGGTATATTGCG -> GGCGTCCAGGTATATTGCGT
CTGTATCATCGTGTGTTTTA -> TGTATCATCGTGTGTTTTAC
AGGGCGCCAACTGGACACCT -> GGGCGCCAACTGGACACCTC
ATTGGGCGAAGAACGCCCTA -> TTGGGCGAAGAACGCCCTAC
AGACGTTAGACCTGTATCAT -> GACGTTAGACCTGTATCATC
ACAGGCTACCTCCGTTTAAG -> CAGGCTACCTCCGTTTAAGC
CGTGATCAACTGTAGGCTGG -> GTGATCAACTGTAGGCTGGA
GACCCTAGTGTCTGAACAGC -> ACCCTAGTGTCTGAACAGCC
CGGGTTCTCCGTTGAACATC -> GGGTTCTCCGTTGAACATCA
TAACCTAGCCAACGTGATCA -> AACCTAGCCAACGTGATCAA
GAAAGGGGCACTTCCTAGTA -> AAAGGGGCACTTCCTAGTAT
GAAGCTTCTTAGGATAACTC -> AAGCTTCTTAGGATAACTCG
ACGCATCGCCGGGGTCGTTA -> CGCATCGCCGGGGTCGTTAC
AGTGAGCGGTGCTGATCAGT -> GTGAGCGGTGCTGATCAGTG
GATTGTAATCCCTTGACAAA -> ATTGTAATCCCTTGACAAAA
GGATCCCCGTCTGAAAAGAG -> GATCCCCGTCTGAAAAGAGG
AGAGTGTACGCATCGCCGGG -> GAGTGTACGCATCGCCGGGG
TTCAGACTCTGCAACGCAGT -> TCAGACTCTGCAACGCAGTG
CTTCTCGCCTTACGGTGTAC -> TTCTCGCCTTACGGTGTACT
TATATTGCGTTTGAGAGCAG -> ATATTGCGTTTGAGAGCAGA
GTGTCTGAACAGCCGCGCGC -> TGTCTGAACAGCCGCGCGCG
TTCGGGACCCTCGCCCGAGC -> TCGGGACCCTCGCCCGAGCT
GCCAACGTGATCAACTGTAG -> CCAACGTGATCAACTGTAGG
TCGTTACGGATAAAAAAAAC -> CGTTACGGATAAAAAAAACG
GTGCTGATCAGTGATTGTAA -> TGCTGATCAGTGATTGTAAT
TGCTCGAAGCTTCTTAGGAT -> GCTCGAAGCTTCTTAGGATA
GTGCGGGAAAAGTTGCGAGG -> TGCGGGAAAAGTTGCGAGGG
CGAAGTGAGCGGTGCTGATC -> GAAGTGAGCGGTGCTGATCA
AACTTAAGACTGACTCATCC -> ACTTAAGACTGACTCATCCC
TATGGCACGAAAACAGTGCG -> ATGGCACGAAAACAGTGCGG
TTGAAAGGGGCACTTCCTAG -> TGAAAGGGGCACTTCCTAGT
CCGCATCTAGGTCAACTAAC -> CGCATCTAGGTCAACTAACA
ACGCGGCTTCTCGCCTTACG -> CGCGGCTTCTCGCCTTACGG
CTGCAACGCAGTGCTGCTAA -> TGCAACGCAGTGCTGCTAAT
CTCCCTAGCCACTGGGATCC -> TCCCTAGCCACTGGGATCCC
GCGCCAACTGGACACCTCGA -> CGCCAACTGGACACCTCGAC
TGAAGTATCGGGGAAGAGTG -> GAAGTATCGGGGAAGAGTGT
GTAATCCCTTGACAAAATTG -> TAATCCCTTGACAAAATTGT
TTGAGCTAGGCTCGGGTTCT -> TGAGCTAGGCTCGGGTTCTC
TCAGGCGGGCGTCCAGGTAT -> CAGGCGGGCGTCCAGGTATA
TTGCGTTAAGTAGTCGAAAC -> TGCGTTAAGTAGTCGAAACC
CCCGTCTGAAAAGAGGGATA -> CCGTCTGAAAAGAGGGATAC
CACCGTTACTGAAACAGTTA -> ACCGTTACTGAAACAGTTAT
TAACGTCAAGCGTCTGTTAA -> AACGTCAAGCGTCTGTTAAC
CCACCGTTACTGAAACAGTT -> CACCGTTACTGAAACAGTTA
TGTCTGAACAGCCGCGCGCG -> GTCTGAACAGCCGCGCGCGC
GAGGGGGGTAACGTCAAGCG -> AGGGGGGTAACGTCAAGCGT
CGGCTTCTCGCCTTACGGTG -> GGCTTCTCGCCTTACGGTGT
AGTCCGATTCGGGACCCTCG -> GTCCGATTCGGGACCCTCGC
AATCCCTTGACAAAATTGTT -> ATCCCTTGACAAAATTGTTG
AGTATATGGTTGAAGTATCG -> GTATATGGTTGAAGTATCGG
GCTGCTAATTGACTCTATCT -> CTGCTAATTGACTCTATCTT
AGTGTCTGAACAGCCGCGCG -> GTGTCTGAACAGCCGCGCGC
CGTTTAAGCAGCCGTGCAGT -> GTTTAAGCAGCCGTGCAGTT
GCGGCTTCTCGCCTTACGGT -> CGGCTTCTCGCCTTACGGTG
GTCGAAACCCAACAATGCAA -> TCGAAACCCAACAATGCAAA
GCTAATTGACTCTATCTTCC -> CTAATTGACTCTATCTTCCT
TTTTTTCAGGCGGGCGTCCA -> TTTTTCAGGCGGGCGTCCAG
TCACTCTTCCACTTGGGGTG -> CACTCTTCCACTTGGGGTGC
GCGGTGCTGATCAGTGATTG -> CGGTGCTGATCAGTGATTGT
TATGGTTGAAGTATCGGGGA -> ATGGTTGAAGTATCGGGGAA
AGACCCAATGCAGATAATCA -> GACCCAATGCAGATAATCAT
TAACACCCTGGTCTGGTATC -> AACACCCTGGTCTGGTATCC
GTTAAAGAGACGTTAGACCT -> TTAAAGAGACGTTAGACCTG
AGTATCGGGGAAGAGTGTAC -> GTATCGGGGAAGAGTGTACG
CTAGAGCTTCTACAGGCTTA -> TAGAGCTTCTACAGGCTTAT
AACCCAACAATGCAAACAAC -> ACCCAACAATGCAAACAACT
TAGACCTGTATCATCGTGTG -> AGACCTGTATCATCGTGTGT
CTTCCACTTGGGGTGCGAAG -> TTCCACTTGGGGTGCGAAGT
GGGCGCCAACTGGACACCTC -> GGCGCCAACTGGACACCTCG
CTGAAACAGTTATGTCGCAG -> TGAAACAGTTATGTCGCAGG
AAGAACGCCCTACCACCGTT -> AGAACGCCCTACCACCGTTA
CCTACCACCGTTACTGAAAC -> CTACCACCGTTACTGAAACA
AGTCCGCCCAACATATTCAT -> GTCCGCCCAACATATTCATT
GGGGGGTAACGTCAAGCGTC -> GGGGGTAACGTCAAGCGTCT
CTATCTTCCTACATTTTTTC -> TATCTTCCTACATTTTTTCA
CAACGCAGTGCTGCTAATTG -> AACGCAGTGCTGCTAATTGA
CTGGACACCTCGACTAGAGC -> TGGACACCTCGACTAGAGCT
GCCAACTGGACACCTCGACT -> CCAACTGGACACCTCGACTA
GGTTGAAGTATCGGGGAAGA -> GTTGAAGTATCGGGGAAGAG
TATCACTCTTCCACTTGGGG -> ATCACTCTTCCACTTGGGGT
CTCGGGTTCTCCGTTGAACA -> TCGGGTTCTCCGTTGAACAT
ATGCTCGAAGCTTCTTAGGA -> TGCTCGAAGCTTCTTAGGAT
AGCTAGGCTCGGGTTCTCCG -> GCTAGGCTCGGGTTCTCCGT
TCGCAGGCGTAAATCTGTAA -> CGCAGGCGTAAATCTGTAAT
GTCGCAGGCGTAAATCTGTA -> TCGCAGGCGTAAATCTGTAA
CTCGGTCCATTGAAAGGGGC -> TCGGTCCATTGAAAGGGGCA
AACGTGATCAACTGTAGGCT -> ACGTGATCAACTGTAGGCTG
CCTAGTGTCTGAACAGCCGC -> CTAGTGTCTGAACAGCCGCG
TTGTCACTTTTGAGCTAGGC -> TGTCACTTTTGAGCTAGGCT
AGTGCTGCTAATTGACTCTA -> GTGCTGCTAATTGACTCTAT
AAACGATGGAGTCCAGACCC -> AACGATGGAGTCCAGACCCA
CCTAGCCACTGGGATCCCCG -> CTAGCCACTGGGATCCCCGT
ACGGGTTCAATACAGACATG -> CGGGTTCAATACAGACATGT
GCTCCCTAGCCACTGGGATC -> CTCCCTAGCCACTGGGATCC
ATTTTTTCAGGCGGGCGTCC -> TTTTTTCAGGCGGGCGTCCA
GGGGTCGTTACGGATAAAAA -> GGGTCGTTACGGATAAAAAA
GCTAGGCTCGGGTTCTCCGT -> CTAGGCTCGGGTTCTCCGTT
TCGCCTTACGGTGTACTCCT -> CGCCTTACGGTGTACTCCTC
CTTCTACAGGCTTATGACAA -> TTCTACAGGCTTATGACAAC
CAAACAACTCGAAACAGGCT -> AAACAACTCGAAACAGGCTA
TTCTTAGGATAACTCGGTCC -> TCTTAGGATAACTCGGTCCA
GAAGAGTAATGTGGTTGCGT -> AAGAGTAATGTGGTTGCGTT
AACCTAGCCAACGTGATCAA -> ACCTAGCCAACGTGATCAAC
CCAACATATTCATTCAGCGA -> CAACATATTCATTCAGCGAC
CGAAAACAGTGCGGGAAAAG -> GAAAACAGTGCGGGAAAAGT
ACATTTTTTCAGGCGGGCGT -> CATTTTTTCAGGCGGGCGTC
ATTGCGTTTGAGAGCAGAGG -> TTGCGTTTGAGAGCAGAGGG
CGGGTTCAATACAGACATGT -> GGGTTCAATACAGACATGTT
CTCTTCCACTTGGGGTGCGA -> TCTTCCACTTGGGGTGCGAA
TGATCAGTGATTGTAATCCC -> GATCAGTGATTGTAATCCCT
GCGCCCTTAGGGCGCCAACT -> CGCCCTTAGGGCGCCAACTG
TGCAGATAATCATAACGCGG -> GCAGATAATCATAACGCGGC
AAAAAACGATGGAGTCCAGA -> AAAAACGATGGAGTCCAGAC
CAACTTAAGACTGACTCATC -> AACTTAAGACTGACTCATCC
AGCTTCTAACCTAGCCAACG -> GCTTCTAACCTAGCCAACGT
TCTTCCACTTGGGGTGCGAA -> CTTCCACTTGGGGTGCGAAG
CTCTATCTTCCTACATTTTT -> TCTATCTTCCTACATTTTTT
GTTCAATACAGACATGTTGC -> TTCAATACAGACATGTTGCG
AGATAATCATAACGCGGCTT -> GATAATCATAACGCGGCTTC
CGCCCTACCACCGTTACTGA -> GCCCTACCACCGTTACTGAA
CCTCGCCCGAGCTCCCTCAA -> CTCGCCCGAGCTCCCTCAAC
GACTCTATCTTCCTACATTT -> ACTCTATCTTCCTACATTTT
TAATCCCTTGACAAAATTGT -> AATCCCTTGACAAAATTGTT
CGCCAACTGGACACCTCGAC -> GCCAACTGGACACCTCGACT
TGCAACGCAGTGCTGCTAAT -> GCAACGCAGTGCTGCTAATT
CATTTTTTCAGGCGGGCGTC -> ATTTTTTCAGGCGGGCGTCC
CGGATTGTCACTTTTGAGCT -> GGATTGTCACTTTTGAGCTA
CTGCCGCATCTAGGTCAACT -> TGCCGCATCTAGGTCAACTA
TAAGACTGACTCATCCCCAG -> AAGACTGACTCATCCCCAGC
CGATGGAGTCCAGACCCAAT -> GATGGAGTCCAGACCCAATG
GAACATCACTCTTACGAAGA -> AACATCACTCTTACGAAGAT
AATATGGCACGAAAACAGTG -> ATATGGCACGAAAACAGTGC
CCAACGTGATCAACTGTAGG -> CAACGTGATCAACTGTAGGC
AACTAACACCCTGGTCTGGT -> ACTAACACCCTGGTCTGGTA
GTTACTGAAACAGTTATGTC -> TTACTGAAACAGTTATGTCG
CTGCTAATTGACTCTATCTT -> TGCTAATTGACTCTATCTTC
AAGAGGGATACTGCCGCATC -> AGAGGGATACTGCCGCATCT
TCTAGGTCAACTAACACCCT -> CTAGGTCAACTAACACCCTG
GTTACGGATAAAAAAAACGA -> TTACGGATAAAAAAAACGAT
TCAACTTAAGACTGACTCAT -> CAACTTAAGACTGACTCATC
AGCAGAGGGCTGGTTAAAGA -> GCAGAGGGCTGGTTAAAGAG
CGCGCCAGTCCGCCCAACAT -> GCGCCAGTCCGCCCAACATA
GCAGATAATCATAACGCGGC -> CAGATAATCATAACGCGGCT
CTCACTTCGGATTGTCACTT -> TCACTTCGGATTGTCACTTT
CGCCGGGGTCGTTACGGATA -> GCCGGGGTCGTTACGGATAA
GGCGTAAATCTGTAATATGG -> GCGTAAATCTGTAATATGGC
CCTGATTGGGCGAAGAACGC -> CTGATTGGGCGAAGAACGCC
AAACCCAACAATGCAAACAA -> AACCCAACAATGCAAACAAC
TGGAGTCCAGACCCAATGCA -> GGAGTCCAGACCCAATGCAG
TTGTTGATGCTCGAAGCTTC -> TGTTGATGCTCGAAGCTTCT
CGTCAAGCGTCTGTTAACGG -> GTCAAGCGTCTGTTAACGGG
AACTGTAGGCTGGACCCTAG -> ACTGTAGGCTGGACCCTAGT
GGATTGTCACTTTTGAGCTA -> GATTGTCACTTTTGAGCTAG
CTCGCAGAATCTATCACTCT -> TCGCAGAATCTATCACTCTT
TGCGAGGGGGGTAACGTCAA -> GCGAGGGGGGTAACGTCAAG
GTCTGAAAAGAGGGATACTG -> TCTGAAAAGAGGGATACTGC
TAGAGCTTCTACAGGCTTAT -> AGAGCTTCTACAGGCTTATG
AGTGATTGTAATCCCTTGAC -> GTGATTGTAATCCCTTGACA
AATGCAAACAACTCGAAACA -> ATGCAAACAACTCGAAACAG
TAGCCAACGTGATCAACTGT -> AGCCAACGTGATCAACTGTA
CATCCCCAGCTTCTAACCTA -> ATCCCCAGCTTCTAACCTAG
CGCGCGCGCGCCAGTCCGCC -> GCGCGCGCGCCAGTCCGCCC
TCGCCGGGGTCGTTACGGAT -> CGCCGGGGTCGTTACGGATA
TCGGATTGTCACTTTTGAGC -> CGGATTGTCACTTTTGAGCT
TCTCGCCTTACGGTGTACTC -> CTCGCCTTACGGTGTACTCC
CTGAACAGCCGCGCGCGCGC -> TGAACAGCCGCGCGCGCGCC
TACAGACATGTTGCGCCCTT -> ACAGACATGTTGCGCCCTTA
CTTCGGATTGTCACTTTTGA -> TTCGGATTGTCACTTTTGAG
TAACTCGGTCCATTGAAAGG -> AACTCGGTCCATTGAAAGGG
AAGACTGACTCATCCCCAGC -> AGACTGACTCATCCCCAGCT
TGCAGTTCTCGCAGAATCTA -> GCAGTTCTCGCAGAATCTAT
GTTGCGAGGGGGGTAACGTC -> TTGCGAGGGGGGTAACGTCA
GGACACCTCGACTAGAGCTT -> GACACCTCGACTAGAGCTTC
GGTTAAAGAGACGTTAGACC -> GTTAAAGAGACGTTAGACCT
AGGCTTATGACAACAGAGTC -> GGCTTATGACAACAGAGTCC
TATCATCGTGTGTTTTACCT -> ATCATCGTGTGTTTTACCTC
ACCCTGGTCTGGTATCCTGA -> CCCTGGTCTGGTATCCTGAT
GGCGAAGAACGCCCTACCAC -> GCGAAGAACGCCCTACCACC
AAGGGGCACTTCCTAGTATA -> AGGGGCACTTCCTAGTATAT
GATCAACTGTAGGCTGGACC -> ATCAACTGTAGGCTGGACCC
TACCTCACTTCGGATTGTCA -> ACCTCACTTCGGATTGTCAC
GACATGTTGCGCCCTTAGGG -> ACATGTTGCGCCCTTAGGGC
GACAAAATTGTTGATGCTCG -> ACAAAATTGTTGATGCTCGA
TCGCAGAATCTATCACTCTT -> CGCAGAATCTATCACTCTTC
ATCGTGTGTTTTACCTCACT -> TCGTGTGTTTTACCTCACTT
ACTGGACACCTCGACTAGAG -> CTGGACACCTCGACTAGAGC
TCGGTCCATTGAAAGGGGCA -> CGGTCCATTGAAAGGGGCAC
CTAACCTAGCCAACGTGATC -> TAACCTAGCCAACGTGATCA
CACCTCGACTAGAGCTTCTA -> ACCTCGACTAGAGCTTCTAC
TCGCCCGAGCTCCCTCAACT -> CGCCCGAGCTCCCTCAACTT
ACGCCCTACCACCGTTACTG -> CGCCCTACCACCGTTACTGA
TACATTTTTTCAGGCGGGCG -> ACATTTTTTCAGGCGGGCGT
GCTCGGGTTCTCCGTTGAAC -> CTCGGGTTCTCCGTTGAACA
GCTTCTAACCTAGCCAACGT -> CTTCTAACCTAGCCAACGTG
GAGCTCCCTCAACTTAAGAC -> AGCTCCCTCAACTTAAGACT
ATCTTCCTACATTTTTTCAG -> TCTTCCTACATTTTTTCAGG
GGTCTGGTATCCTGATTGGG -> GTCTGGTATCCTGATTGGGC
AACAGAGTCCGATTCGGGAC -> ACAGAGTCCGATTCGGGACC
TATCTTCCTACATTTTTTCA -> ATCTTCCTACATTTTTTCAG
GCTACCTCCGTTTAAGCAGC -> CTACCTCCGTTTAAGCAGCC
TTGATGCTCGAAGCTTCTTA -> TGATGCTCGAAGCTTCTTAG
GTCCAGGTATATTGCGTTTG -> TCCAGGTATATTGCGTTTGA
CCGTTGAACATCACTCTTAC -> CGTTGAACATCACTCTTACG
AAAAAAACGATGGAGTCCAG -> AAAAAACGATGGAGTCCAGA
TGGACACCTCGACTAGAGCT -> GGACACCTCGACTAGAGCTT
TGCTGATCAGTGATTGTAAT -> GCTGATCAGTGATTGTAATC
GTCAACTAACACCCTGGTCT -> TCAACTAACACCCTGGTCTG
AACATATTCATTCAGCGACC -> ACATATTCATTCAGCGACCA
ATTGAAAGGGGCACTTCCTA -> TTGAAAGGGGCACTTCCTAG
CCCTCGCCCGAGCTCCCTCA -> CCTCGCCCGAGCTCCCTCAA
CAATGCAGATAATCATAACG -> AATGCAGATAATCATAACGC
TTCAGCGACCACGTTCAGAC -> TCAGCGACCACGTTCAGACT
GCAGCCGTGCAGTTCTCGCA -> CAGCCGTGCAGTTCTCGCAG
ATAACGCGGCTTCTCGCCTT -> TAACGCGGCTTCTCGCCTTA
GCGTCTGTTAACGGGTTCAA -> CGTCTGTTAACGGGTTCAAT
CCTCAACTTAAGACTGACTC -> CTCAACTTAAGACTGACTCA
TTGTAATCCCTTGACAAAAT -> TGTAATCCCTTGACAAAATT
TACGGTGTACTCCTCGCTCC -> ACGGTGTACTCCTCGCTCCC
TTGACTCTATCTTCCTACAT -> TGACTCTATCTTCCTACATT
CAGGCGTAAATCTGTAATAT -> AGGCGTAAATCTGTAATATG
AAGCAGCCGTGCAGTTCTCG -> AGCAGCCGTGCAGTTCTCGC
TAGGCTGGACCCTAGTGTCT -> AGGCTGGACCCTAGTGTCTG
AACAGTTATGTCGCAGGCGT -> ACAGTTATGTCGCAGGCGTA
TCCCTTGACAAAATTGTTGA -> CCCTTGACAAAATTGTTGAT
GATTCGGGACCCTCGCCCGA -> ATTCGGGACCCTCGCCCGAG
CGCCTTACGGTGTACTCCTC -> GCCTTACGGTGTACTCCTCG
ACAGCCGCGCGCGCGCCAGT -> CAGCCGCGCGCGCGCCAGTC
ATGTTGCGCCCTTAGGGCGC -> TGTTGCGCCCTTAGGGCGCC
AAAAACGATGGAGTCCAGAC -> AAAACGATGGAGTCCAGACC
TCTAACCTAGCCAACGTGAT -> CTAACCTAGCCAACGTGATC
GCGGGAAAAGTTGCGAGGGG -> CGGGAAAAGTTGCGAGGGGG
CGGGCGTCCAGGTATATTGC -> GGGCGTCCAGGTATATTGCG
CCCAACATATTCATTCAGCG -> CCAACATATTCATTCAGCGA
CTCGAAACAGGCTACCTCCG -> TCGAAACAGGCTACCTCCGT
CACTTCCTAGTATATGGTTG -> ACTTCCTAGTATATGGTTGA
AAGCGTCTGTTAACGGGTTC -> AGCGTCTGTTAACGGGTTCA
GTACTCCTCGCTCCCTAGCC -> TACTCCTCGCTCCCTAGCCA
TGAGCGGTGCTGATCAGTGA -> GAGCGGTGCTGATCAGTGAT
ATCTATCACTCTTCCACTTG -> TCTATCACTCTTCCACTTGG
CTGGTTAAAGAGACGTTAGA -> TGGTTAAAGAGACGTTAGAC
CTGGTATCCTGATTGGGCGA -> TGGTATCCTGATTGGGCGAA
CTTAGGGCGCCAACTGGACA -> TTAGGGCGCCAACTGGACAC
GAATCTATCACTCTTCCACT -> AATCTATCACTCTTCCACTT
GGTGTACTCCTCGCTCCCTA -> GTGTACTCCTCGCTCCCTAG
CAGAGGGCTGGTTAAAGAGA -> AGAGGGCTGGTTAAAGAGAC
CAGCGACCACGTTCAGACTC -> AGCGACCACGTTCAGACTCT
GAAGTGAGCGGTGCTGATCA -> AAGTGAGCGGTGCTGATCAG
CTGGACCCTAGTGTCTGAAC -> TGGACCCTAGTGTCTGAACA
GTATATGGTTGAAGTATCGG -> TATATGGTTGAAGTATCGGG
TATTCATTCAGCGACCACGT -> ATTCATTCAGCGACCACGTT
AATGCAGATAATCATAACGC -> ATGCAGATAATCATAACGCG
CAATGCAAACAACTCGAAAC -> AATGCAAACAACTCGAAACA
GAGTCCGATTCGGGACCCTC -> AGTCCGATTCGGGACCCTCG
CCTACATTTTTTCAGGCGGG -> CTACATTTTTTCAGGCGGGC
TCAGACTCTGCAACGCAGTG -> CAGACTCTGCAACGCAGTGC
CACTTTTGAGCTAGGCTCGG -> ACTTTTGAGCTAGGCTCGGG
GTTCTCCGTTGAACATCACT -> TTCTCCGTTGAACATCACTC
ATCCCTTGACAAAATTGTTG -> TCCCTTGACAAAATTGTTGA
AGAGCTTCTACAGGCTTATG -> GAGCTTCTACAGGCTTATGA
CCCAATGCAGATAATCATAA -> CCAATGCAGATAATCATAAC
CTGATCAGTGATTGTAATCC -> TGATCAGTGATTGTAATCCC
TAACGCGGCTTCTCGCCTTA -> AACGCGGCTTCTCGCCTTAC
CATAACGCGGCTTCTCGCCT -> ATAACGCGGCTTCTCGCCTT
GGGATACTGCCGCATCTAGG -> GGATACTGCCGCATCTAGGT
GGATAAAAAAAACGATGGAG -> GATAAAAAAAACGATGGAGT
GCCACTGGGATCCCCGTCTG -> CCACTGGGATCCCCGTCTGA
ACTCTTACGAAGATTTATCT -> CTCTTACGAAGATTTATCTA
CTGTAGGCTGGACCCTAGTG -> TGTAGGCTGGACCCTAGTGT
GTAATATGGCACGAAAACAG -> TAATATGGCACGAAAACAGT
GAACGCCCTACCACCGTTAC -> AACGCCCTACCACCGTTACT
TGGTCTGGTATCCTGATTGG -> GGTCTGGTATCCTGATTGGG
CAGGTATATTGCGTTTGAGA -> AGGTATATTGCGTTTGAGAG
CAACAATGCAAACAACTCGA -> AACAATGCAAACAACTCGAA
CCCTACCACCGTTACTGAAA -> CCTACCACCGTTACTGAAAC
TTAAGCAGCCGTGCAGTTCT -> TAAGCAGCCGTGCAGTTCTC
CGAAGAGTAATGTGGTTGCG -> GAAGAGTAATGTGGTTGCGT
TGTACGCATCGCCGGGGTCG -> GTACGCATCGCCGGGGTCGT
GCCAGTCCGCCCAACATATT -> CCAGTCCGCCCAACATATTC
ACTCATCCCCAGCTTCTAAC -> CTCATCCCCAGCTTCTAACC
TGGGATCCCCGTCTGAAAAG -> GGGATCCCCGTCTGAAAAGA
TTCAGGCGGGCGTCCAGGTA -> TCAGGCGGGCGTCCAGGTAT
CCTAGTATATGGTTGAAGTA -> CTAGTATATGGTTGAAGTAT
GAAAACAGTGCGGGAAAAGT -> AAAACAGTGCGGGAAAAGTT
CAGGCGGGCGTCCAGGTATA -> AGGCGGGCGTCCAGGTATAT
GTTAGACCTGTATCATCGTG -> TTAGACCTGTATCATCGTGT
CTGTAATATGGCACGAAAAC -> TGTAATATGGCACGAAAACA
AAAGTTGCGAGGGGGGTAAC -> AAGTTGCGAGGGGGGTAACG
GTAGTCGAAACCCAACAATG -> TAGTCGAAACCCAACAATGC
ATAAAAAAAACGATGGAGTC -> TAAAAAAAACGATGGAGTCC
ACTCTTCCACTTGGGGTGCG -> CTCTTCCACTTGGGGTGCGA
TGATGCTCGAAGCTTCTTAG -> GATGCTCGAAGCTTCTTAGG
CTTGACAAAATTGTTGATGC -> TTGACAAAATTGTTGATGCT
ACTCTGCAACGCAGTGCTGC -> CTCTGCAACGCAGTGCTGCT
GAGTGTACGCATCGCCGGGG -> AGTGTACGCATCGCCGGGGT
GGGAAAAGTTGCGAGGGGGG -> GGAAAAGTTGCGAGGGGGGT
GTGCTGCTAATTGACTCTAT -> TGCTGCTAATTGACTCTATC
GATAAAAAAAACGATGGAGT -> ATAAAAAAAACGATGGAGTC
GATTGTCACTTTTGAGCTAG -> ATTGTCACTTTTGAGCTAGG
GCAGGCGTAAATCTGTAATA -> CAGGCGTAAATCTGTAATAT
CTTACGGTGTACTCCTCGCT -> TTACGGTGTACTCCTCGCTC
GCCGCGCGCGCGCCAGTCCG -> CCGCGCGCGCGCCAGTCCGC
ACTCGGTCCATTGAAAGGGG -> CTCGGTCCATTGAAAGGGGC
TCTGTAATATGGCACGAAAA -> CTGTAATATGGCACGAAAAC
CTACAGGCTTATGACAACAG -> TACAGGCTTATGACAACAGA
CCAATGCAGATAATCATAAC -> CAATGCAGATAATCATAACG
CCCGAGCTCCCTCAACTTAA -> CCGAGCTCCCTCAACTTAAG
TGCGGGAAAAGTTGCGAGGG -> GCGGGAAAAGTTGCGAGGGG
CCTTGACAAAATTGTTGATG -> CTTGACAAAATTGTTGATGC
AGCCGCGCGCGCGCCAGTCC -> GCCGCGCGCGCGCCAGTCCG
CAGCCGTGCAGTTCTCGCAG -> AGCCGTGCAGTTCTCGCAGA
CCCCAGCTTCTAACCTAGCC -> CCCAGCTTCTAACCTAGCCA
CCGCCCAACATATTCATTCA -> CGCCCAACATATTCATTCAG
AGCCACTGGGATCCCCGTCT -> GCCACTGGGATCCCCGTCTG
GCTGGTTAAAGAGACGTTAG -> CTGGTTAAAGAGACGTTAGA
CCTCCGTTTAAGCAGCCGTG -> CTCCGTTTAAGCAGCCGTGC
TATGACAACAGAGTCCGATT -> ATGACAACAGAGTCCGATTC
TATCGGGGAAGAGTGTACGC -> ATCGGGGAAGAGTGTACGCA
CCCAGCTTCTAACCTAGCCA -> CCAGCTTCTAACCTAGCCAA
ACTCCTCGCTCCCTAGCCAC -> CTCCTCGCTCCCTAGCCACT
TCCTAGTATATGGTTGAAGT -> CCTAGTATATGGTTGAAGTA
GACGTTAGACCTGTATCATC -> ACGTTAGACCTGTATCATCG
CCGATTCGGGACCCTCGCCC -> CGATTCGGGACCCTCGCCCG
CACCCTGGTCTGGTATCCTG -> ACCCTGGTCTGGTATCCTGA
GTGTACGCATCGCCGGGGTC -> TGTACGCATCGCCGGGGTCG
ACAACTCGAAACAGGCTACC -> CAACTCGAAACAGGCTACCT
TCACTCTTACGAAGATTTAT -> CACTCTTACGAAGATTTATC
CGACTAGAGCTTCTACAGGC -> GACTAGAGCTTCTACAGGCT
TCTGTTAACGGGTTCAATAC -> CTGTTAACGGGTTCAATACA
CAGTTCTCGCAGAATCTATC -> AGTTCTCGCAGAATCTATCA
GCTGGACCCTAGTGTCTGAA -> CTGGACCCTAGTGTCTGAAC
CGTTACGGATAAAAAAAACG -> GTTACGGATAAAAAAAACGA
AGTCCAGACCCAATGCAGAT -> GTCCAGACCCAATGCAGATA
TCCGCCCAACATATTCATTC -> CCGCCCAACATATTCATTCA
TCGGGGAAGAGTGTACGCAT -> CGGGGAAGAGTGTACGCATC
TATTGCGTTTGAGAGCAGAG -> ATTGCGTTTGAGAGCAGAGG
ATATTCATTCAGCGACCACG -> TATTCATTCAGCGACCACGT
TCGGGACCCTCGCCCGAGCT -> CGGGACCCTCGCCCGAGCTC
ACTGAAACAGTTATGTCGCA -> CTGAAACAGTTATGTCGCAG
ATACAGACATGTTGCGCCCT -> TACAGACATGTTGCGCCCTT
CATCGTGTGTTTTACCTCAC -> ATCGTGTGTTTTACCTCACT
TACGCATCGCCGGGGTCGTT -> ACGCATCGCCGGGGTCGTTA
TGATCAACTGTAGGCTGGAC -> GATCAACTGTAGGCTGGACC
ATGGTTGAAGTATCGGGGAA -> TGGTTGAAGTATCGGGGAAG
GAGTAATGTGGTTGCGTTAA -> AGTAATGTGGTTGCGTTAAG
AACGTCAAGCGTCTGTTAAC -> ACGTCAAGCGTCTGTTAACG
TTAGGATAACTCGGTCCATT -> TAGGATAACTCGGTCCATTG
GGCTTCTCGCCTTACGGTGT -> GCTTCTCGCCTTACGGTGTA
TTCCTAGTATATGGTTGAAG -> TCCTAGTATATGGTTGAAGT
AGCGACCACGTTCAGACTCT -> GCGACCACGTTCAGACTCTG
AGACCTGTATCATCGTGTGT -> GACCTGTATCATCGTGTGTT
ACCTCCGTTTAAGCAGCCGT -> CCTCCGTTTAAGCAGCCGTG
GCGCGCGCCAGTCCGCCCAA -> CGCGCGCCAGTCCGCCCAAC
TCTATCTTCCTACATTTTTT -> CTATCTTCCTACATTTTTTC
AGCTTCTACAGGCTTATGAC -> GCTTCTACAGGCTTATGACA
ACAGTTATGTCGCAGGCGTA -> CAGTTATGTCGCAGGCGTAA
CGCATCTAGGTCAACTAACA -> GCATCTAGGTCAACTAACAC
CAACTGTAGGCTGGACCCTA -> AACTGTAGGCTGGACCCTAG
GCTTCTTAGGATAACTCGGT -> CTTCTTAGGATAACTCGGTC
CCGTTACTGAAACAGTTATG -> CGTTACTGAAACAGTTATGT
GCGTCCAGGTATATTGCGTT -> CGTCCAGGTATATTGCGTTT
ACGTCAAGCGTCTGTTAACG -> CGTCAAGCGTCTGTTAACGG
ACCTCGACTAGAGCTTCTAC -> CCTCGACTAGAGCTTCTACA
GCGCCAGTCCGCCCAACATA -> CGCCAGTCCGCCCAACATAT
ACAGTGCGGGAAAAGTTGCG -> CAGTGCGGGAAAAGTTGCGA
CGGATAAAAAAAACGATGGA -> GGATAAAAAAAACGATGGAG
TTACCTCACTTCGGATTGTC -> TACCTCACTTCGGATTGTCA
TCGAAGCTTCTTAGGATAAC -> CGAAGCTTCTTAGGATAACT
AGCCGTGCAGTTCTCGCAGA -> GCCGTGCAGTTCTCGCAGAA
CCCTTGACAAAATTGTTGAT -> CCTTGACAAAATTGTTGATG
GGGACCCTCGCCCGAGCTCC -> GGACCCTCGCCCGAGCTCCC
GGTATCCTGATTGGGCGAAG -> GTATCCTGATTGGGCGAAGA
ACCTCACTTCGGATTGTCAC -> CCTCACTTCGGATTGTCACT
ATCGGGGAAGAGTGTACGCA -> TCGGGGAAGAGTGTACGCAT
GTCTGTTAACGGGTTCAATA -> TCTGTTAACGGGTTCAATAC
CGTTGAACATCACTCTTACG -> GTTGAACATCACTCTTACGA
AATCATAACGCGGCTTCTCG -> ATCATAACGCGGCTTCTCGC
CTGAAAAGAGGGATACTGCC -> TGAAAAGAGGGATACTGCCG
ATCATAACGCGGCTTCTCGC -> TCATAACGCGGCTTCTCGCC
CAGACCCAATGCAGATAATC -> AGACCCAATGCAGATAATCA
TCTTAGGATAACTCGGTCCA -> CTTAGGATAACTCGGTCCAT
ATACTGCCGCATCTAGGTCA -> TACTGCCGCATCTAGGTCAA
TGGTATCCTGATTGGGCGAA -> GGTATCCTGATTGGGCGAAG
GGGTTCAATACAGACATGTT -> GGTTCAATACAGACATGTTG
TTATGACAACAGAGTCCGAT -> TATGACAACAGAGTCCGATT
CTGTTAACGGGTTCAATACA -> TGTTAACGGGTTCAATACAG
CACTTGGGGTGCGAAGTGAG -> ACTTGGGGTGCGAAGTGAGC
AAACAGTGCGGGAAAAGTTG -> AACAGTGCGGGAAAAGTTGC
AGGGCTGGTTAAAGAGACGT -> GGGCTGGTTAAAGAGACGTT
AGACATGTTGCGCCCTTAGG -> GACATGTTGCGCCCTTAGGG
AGGTCAACTAACACCCTGGT -> GGTCAACTAACACCCTGGTC
TTATGTCGCAGGCGTAAATC -> TATGTCGCAGGCGTAAATCT
ACTGCCGCATCTAGGTCAAC -> CTGCCGCATCTAGGTCAACT
GGGCTGGTTAAAGAGACGTT -> GGCTGGTTAAAGAGACGTTA
GGATACTGCCGCATCTAGGT -> GATACTGCCGCATCTAGGTC
CCAGGTATATTGCGTTTGAG -> CAGGTATATTGCGTTTGAGA
CTCGCCTTACGGTGTACTCC -> TCGCCTTACGGTGTACTCCT
GGGATCCCCGTCTGAAAAGA -> GGATCCCCGTCTGAAAAGAG
AAATTGTTGATGCTCGAAGC -> AATTGTTGATGCTCGAAGCT
ACAGACATGTTGCGCCCTTA -> CAGACATGTTGCGCCCTTAG
CAGTGCTGCTAATTGACTCT -> AGTGCTGCTAATTGACTCTA
AGTTGCGAGGGGGGTAACGT -> GTTGCGAGGGGGGTAACGTC
CGTGCAGTTCTCGCAGAATC -> GTGCAGTTCTCGCAGAATCT
AACGATGGAGTCCAGACCCA -> ACGATGGAGTCCAGACCCAA
TGCGCCCTTAGGGCGCCAAC -> GCGCCCTTAGGGCGCCAACT
ACTAGAGCTTCTACAGGCTT -> CTAGAGCTTCTACAGGCTTA
TAGGTCAACTAACACCCTGG -> AGGTCAACTAACACCCTGGT
ATTGTAATCCCTTGACAAAA -> TTGTAATCCCTTGACAAAAT
CACTCTTCCACTTGGGGTGC -> ACTCTTCCACTTGGGGTGCG
TAGGATAACTCGGTCCATTG -> AGGATAACTCGGTCCATTGA
CTCTGCAACGCAGTGCTGCT -> TCTGCAACGCAGTGCTGCTA
TGACTCATCCCCAGCTTCTA -> GACTCATCCCCAGCTTCTAA
GCGAAGTGAGCGGTGCTGAT -> CGAAGTGAGCGGTGCTGATC
GCCGGGGTCGTTACGGATAA -> CCGGGGTCGTTACGGATAAA
TATGTCGCAGGCGTAAATCT -> ATGTCGCAGGCGTAAATCTG
GCGTTAAGTAGTCGAAACCC -> CGTTAAGTAGTCGAAACCCA
TGAAAGGGGCACTTCCTAGT -> GAAAGGGGCACTTCCTAGTA
CCAGCTTCTAACCTAGCCAA -> CAGCTTCTAACCTAGCCAAC
CTTCCTAGTATATGGTTGAA -> TTCCTAGTATATGGTTGAAG
ATCCCCAGCTTCTAACCTAG -> TCCCCAGCTTCTAACCTAGC
TTCTCGCCTTACGGTGTACT -> TCTCGCCTTACGGTGTACTC
TGCGTTAAGTAGTCGAAACC -> GCGTTAAGTAGTCGAAACCC
CAGAATCTATCACTCTTCCA -> AGAATCTATCACTCTTCCAC
ACGGTGTACTCCTCGCTCCC -> CGGTGTACTCCTCGCTCCCT
TTAAAGAGACGTTAGACCTG -> TAAAGAGACGTTAGACCTGT
TCTTCCTACATTTTTTCAGG -> CTTCCTACATTTTTTCAGGC
CAACATATTCATTCAGCGAC -> AACATATTCATTCAGCGACC
GGTAACGTCAAGCGTCTGTT -> GTAACGTCAAGCGTCTGTTA
TCCCTCAACTTAAGACTGAC -> CCCTCAACTTAAGACTGACT
TAACGGGTTCAATACAGACA -> AACGGGTTCAATACAGACAT
TTCTCGCAGAATCTATCACT -> TCTCGCAGAATCTATCACTC
CAGAGTCCGATTCGGGACCC -> AGAGTCCGATTCGGGACCCT
GGTTGCGTTAAGTAGTCGAA -> GTTGCGTTAAGTAGTCGAAA
ACTGTAGGCTGGACCCTAGT -> CTGTAGGCTGGACCCTAGTG
CGGGGAAGAGTGTACGCATC -> GGGGAAGAGTGTACGCATCG
GGGGTGCGAAGTGAGCGGTG -> GGGTGCGAAGTGAGCGGTGC
TCTCCGTTGAACATCACTCT -> CTCCGTTGAACATCACTCTT
CTAGTATATGGTTGAAGTAT -> TAGTATATGGTTGAAGTATC
GAAAAGTTGCGAGGGGGGTA -> AAAAGTTGCGAGGGGGGTAA
GCACGAAAACAGTGCGGGAA -> CACGAAAACAGTGCGGGAAA
TGGTTGCGTTAAGTAGTCGA -> GGTTGCGTTAAGTAGTCGAA
AGTTCTCGCAGAATCTATCA -> GTTCTCGCAGAATCTATCAC
GGTGCTGATCAGTGATTGTA -> GTGCTGATCAGTGATTGTAA
CAATACAGACATGTTGCGCC -> AATACAGACATGTTGCGCCC
GGTTCTCCGTTGAACATCAC -> GTTCTCCGTTGAACATCACT
CATATTCATTCAGCGACCAC -> ATATTCATTCAGCGACCACG
AACTGGACACCTCGACTAGA -> ACTGGACACCTCGACTAGAG
TAGTCGAAACCCAACAATGC -> AGTCGAAACCCAACAATGCA
GCATCGCCGGGGTCGTTACG -> CATCGCCGGGGTCGTTACGG
GAGCTTCTACAGGCTTATGA -> AGCTTCTACAGGCTTATGAC
AGCGGTGCTGATCAGTGATT -> GCGGTGCTGATCAGTGATTG
GAGAGCAGAGGGCTGGTTAA -> AGAGCAGAGGGCTGGTTAAA
CGTTACTGAAACAGTTATGT -> GTTACTGAAACAGTTATGTC
ATGACAACAGAGTCCGATTC -> TGACAACAGAGTCCGATTCG
GCCGTGCAGTTCTCGCAGAA -> CCGTGCAGTTCTCGCAGAAT
AGTAATGTGGTTGCGTTAAG -> GTAATGTGGTTGCGTTAAGT
ATCCCCGTCTGAAAAGAGGG -> TCCCCGTCTGAAAAGAGGGA
CATCTAGGTCAACTAACACC -> ATCTAGGTCAACTAACACCC
AAGAGTGTACGCATCGCCGG -> AGAGTGTACGCATCGCCGGG
ATCACTCTTCCACTTGGGGT -> TCACTCTTCCACTTGGGGTG
AAACAACTCGAAACAGGCTA -> AACAACTCGAAACAGGCTAC
TTCGGATTGTCACTTTTGAG -> TCGGATTGTCACTTTTGAGC
TTGCGTTTGAGAGCAGAGGG -> TGCGTTTGAGAGCAGAGGGC
ACGAAAACAGTGCGGGAAAA -> CGAAAACAGTGCGGGAAAAG
TCGCTCCCTAGCCACTGGGA -> CGCTCCCTAGCCACTGGGAT
ATGCAGATAATCATAACGCG -> TGCAGATAATCATAACGCGG
GGAAGAGTGTACGCATCGCC -> GAAGAGTGTACGCATCGCCG
TTCCACTTGGGGTGCGAAGT -> TCCACTTGGGGTGCGAAGTG
CCACTGGGATCCCCGTCTGA -> CACTGGGATCCCCGTCTGAA
GCAGAGGGCTGGTTAAAGAG -> CAGAGGGCTGGTTAAAGAGA
TCCAGGTATATTGCGTTTGA -> CCAGGTATATTGCGTTTGAG
CTCATCCCCAGCTTCTAACC -> TCATCCCCAGCTTCTAACCT
TCCGTTGAACATCACTCTTA -> CCGTTGAACATCACTCTTAC
GCCCGAGCTCCCTCAACTTA -> CCCGAGCTCCCTCAACTTAA
TCTATCACTCTTCCACTTGG -> CTATCACTCTTCCACTTGGG
CGCCAGTCCGCCCAACATAT -> GCCAGTCCGCCCAACATATT
AATACAGACATGTTGCGCCC -> ATACAGACATGTTGCGCCCT
GAAGAACGCCCTACCACCGT -> AAGAACGCCCTACCACCGTT
TAGGGCGCCAACTGGACACC -> AGGGCGCCAACTGGACACCT
TGAGCTAGGCTCGGGTTCTC -> GAGCTAGGCTCGGGTTCTCC
GCTCGAAGCTTCTTAGGATA -> CTCGAAGCTTCTTAGGATAA
GTGCGAAGTGAGCGGTGCTG -> TGCGAAGTGAGCGGTGCTGA
AAGTAGTCGAAACCCAACAA -> AGTAGTCGAAACCCAACAAT
ACTGACTCATCCCCAGCTTC -> CTGACTCATCCCCAGCTTCT
TCTGAACAGCCGCGCGCGCG -> CTGAACAGCCGCGCGCGCGC
GGGTAACGTCAAGCGTCTGT -> GGTAACGTCAAGCGTCTGTT
GATAATCATAACGCGGCTTC -> ATAATCATAACGCGGCTTCT
CGGGGTCGTTACGGATAAAA -> GGGGTCGTTACGGATAAAAA
CCAACTGGACACCTCGACTA -> CAACTGGACACCTCGACTAG
ACATCACTCTTACGAAGATT -> CATCACTCTTACGAAGATTT
ACTGGGATCCCCGTCTGAAA -> CTGGGATCCCCGTCTGAAAA
CTACCTCCGTTTAAGCAGCC -> TACCTCCGTTTAAGCAGCCG
CCGTCTGAAAAGAGGGATAC -> CGTCTGAAAAGAGGGATACT
CATCGCCGGGGTCGTTACGG -> ATCGCCGGGGTCGTTACGGA
TTTCAGGCGGGCGTCCAGGT -> TTCAGGCGGGCGTCCAGGTA
GAAGTATCGGGGAAGAGTGT -> AAGTATCGGGGAAGAGTGTA
CTGATTGGGCGAAGAACGCC -> TGATTGGGCGAAGAACGCCC
TTCCTACATTTTTTCAGGCG -> TCCTACATTTTTTCAGGCGG
CGCAGGCGTAAATCTGTAAT -> GCAGGCGTAAATCTGTAATA
AGGGGGGTAACGTCAAGCGT -> GGGGGGTAACGTCAAGCGTC
GACACCTCGACTAGAGCTTC -> ACACCTCGACTAGAGCTTCT
ATATTGCGTTTGAGAGCAGA -> TATTGCGTTTGAGAGCAGAG
GCGCGCGCGCCAGTCCGCCC -> CGCGCGCGCCAGTCCGCCCA
GCGCGCCAGTCCGCCCAACA -> CGCGCCAGTCCGCCCAACAT
CCCTCAACTTAAGACTGACT -> CCTCAACTTAAGACTGACTC
GCAAACAACTCGAAACAGGC -> CAAACAACTCGAAACAGGCT
TGTACTCCTCGCTCCCTAGC -> GTACTCCTCGCTCCCTAGCC
GATCAGTGATTGTAATCCCT -> ATCAGTGATTGTAATCCCTT
TGAAAAGAGGGATACTGCCG -> GAAAAGAGGGATACTGCCGC
GGGCGAAGAACGCCCTACCA -> GGCGAAGAACGCCCTACCAC
AGACTCTGCAACGCAGTGCT -> GACTCTGCAACGCAGTGCTG
TTAGACCTGTATCATCGTGT -> TAGACCTGTATCATCGTGTG
CCATTGAAAGGGGCACTTCC -> CATTGAAAGGGGCACTTCCT
TTGAGAGCAGAGGGCTGGTT -> TGAGAGCAGAGGGCTGGTTA
CACTGGGATCCCCGTCTGAA -> ACTGGGATCCCCGTCTGAAA
TGCTAATTGACTCTATCTTC -> GCTAATTGACTCTATCTTCC
TAATTGACTCTATCTTCCTA -> AATTGACTCTATCTTCCTAC
TTGAAGTATCGGGGAAGAGT -> TGAAGTATCGGGGAAGAGTG
TCAACTAACACCCTGGTCTG -> CAACTAACACCCTGGTCTGG
CCAGTCCGCCCAACATATTC -> CAGTCCGCCCAACATATTCA
TTGACAAAATTGTTGATGCT -> TGACAAAATTGTTGATGCTC
CCCTTAGGGCGCCAACTGGA -> CCTTAGGGCGCCAACTGGAC
CAGACATGTTGCGCCCTTAG -> AGACATGTTGCGCCCTTAGG
AGGCTGGACCCTAGTGTCTG -> GGCTGGACCCTAGTGTCTGA
ATTGACTCTATCTTCCTACA -> TTGACTCTATCTTCCTACAT
TCTGAAAAGAGGGATACTGC -> CTGAAAAGAGGGATACTGCC
CGCAGAATCTATCACTCTTC -> GCAGAATCTATCACTCTTCC
TCCAGACCCAATGCAGATAA -> CCAGACCCAATGCAGATAAT
TTACTGAAACAGTTATGTCG -> TACTGAAACAGTTATGTCGC
ATTCGGGACCCTCGCCCGAG -> TTCGGGACCCTCGCCCGAGC
TCGAAACCCAACAATGCAAA -> CGAAACCCAACAATGCAAAC
CGCATCGCCGGGGTCGTTAC -> GCATCGCCGGGGTCGTTACG
TTAAGACTGACTCATCCCCA -> TAAGACTGACTCATCCCCAG
CACTTCGGATTGTCACTTTT -> ACTTCGGATTGTCACTTTTG
GCCCTACCACCGTTACTGAA -> CCCTACCACCGTTACTGAAA
CGTTAGACCTGTATCATCGT -> GTTAGACCTGTATCATCGTG
TGCTGCTAATTGACTCTATC -> GCTGCTAATTGACTCTATCT
GTTGCGTTAAGTAGTCGAAA -> TTGCGTTAAGTAGTCGAAAC
GCGAGGGGGGTAACGTCAAG -> CGAGGGGGGTAACGTCAAGC
CGAAGAACGCCCTACCACCG -> GAAGAACGCCCTACCACCGT
TTAGGGCGCCAACTGGACAC -> TAGGGCGCCAACTGGACACC
TTCAATACAGACATGTTGCG -> TCAATACAGACATGTTGCGC
ATGCAAACAACTCGAAACAG -> TGCAAACAACTCGAAACAGG
GGCGCCAACTGGACACCTCG -> GCGCCAACTGGACACCTCGA
AGAGACGTTAGACCTGTATC -> GAGACGTTAGACCTGTATCA
CGCTCCCTAGCCACTGGGAT -> GCTCCCTAGCCACTGGGATC
AGGCGGGCGTCCAGGTATAT -> GGCGGGCGTCCAGGTATATT
CCTGTATCATCGTGTGTTTT -> CTGTATCATCGTGTGTTTTA
CGAGGGGGGTAACGTCAAGC -> GAGGGGGGTAACGTCAAGCG
GCATCTAGGTCAACTAACAC -> CATCTAGGTCAACTAACACC
GGAGTCCAGACCCAATGCAG -> GAGTCCAGACCCAATGCAGA
TCCACTTGGGGTGCGAAGTG -> CCACTTGGGGTGCGAAGTGA
ACGATGGAGTCCAGACCCAA -> CGATGGAGTCCAGACCCAAT
TTAAGTAGTCGAAACCCAAC -> TAAGTAGTCGAAACCCAACA
ACAATGCAAACAACTCGAAA -> CAATGCAAACAACTCGAAAC
GATAACTCGGTCCATTGAAA -> ATAACTCGGTCCATTGAAAG
GACTCTGCAACGCAGTGCTG -> ACTCTGCAACGCAGTGCTGC
CAGTGATTGTAATCCCTTGA -> AGTGATTGTAATCCCTTGAC
GTTCAGACTCTGCAACGCAG -> TTCAGACTCTGCAACGCAGT
TCCCCGTCTGAAAAGAGGGA -> CCCCGTCTGAAAAGAGGGAT
GTCTGAACAGCCGCGCGCGC -> TCTGAACAGCCGCGCGCGCG
CAGTTATGTCGCAGGCGTAA -> AGTTATGTCGCAGGCGTAAA
CAGGCTTATGACAACAGAGT -> AGGCTTATGACAACAGAGTC
AGGCTACCTCCGTTTAAGCA -> GGCTACCTCCGTTTAAGCAG
GAAAAGAGGGATACTGCCGC -> AAAAGAGGGATACTGCCGCA
CCGTGCAGTTCTCGCAGAAT -> CGTGCAGTTCTCGCAGAATC
GTTGAAGTATCGGGGAAGAG -> TTGAAGTATCGGGGAAGAGT
GTGAGCGGTGCTGATCAGTG -> TGAGCGGTGCTGATCAGTGA
TGACTCTATCTTCCTACATT -> GACTCTATCTTCCTACATTT
TCTACAGGCTTATGACAACA -> CTACAGGCTTATGACAACAG
ACCCTCGCCCGAGCTCCCTC -> CCCTCGCCCGAGCTCCCTCA
TGGGGTGCGAAGTGAGCGGT -> GGGGTGCGAAGTGAGCGGTG
CAGGCTACCTCCGTTTAAGC -> AGGCTACCTCCGTTTAAGCA
TAGTGTCTGAACAGCCGCGC -> AGTGTCTGAACAGCCGCGCG
ATCTAGGTCAACTAACACCC -> TCTAGGTCAACTAACACCCT
ACATATTCATTCAGCGACCA -> CATATTCATTCAGCGACCAC
TCCTACATTTTTTCAGGCGG -> CCTACATTTTTTCAGGCGGG
GCGAAGAACGCCCTACCACC -> CGAAGAACGCCCTACCACCG
TCTGCAACGCAGTGCTGCTA -> CTGCAACGCAGTGCTGCTAA
ATGTCGCAGGCGTAAATCTG -> TGTCGCAGGCGTAAATCTGT
CGCAGTGCTGCTAATTGACT -> GCAGTGCTGCTAATTGACTC
ATATGGCACGAAAACAGTGC -> TATGGCACGAAAACAGTGCG
GTTAAGTAGTCGAAACCCAA -> TTAAGTAGTCGAAACCCAAC
GGGGTAACGTCAAGCGTCTG -> GGGTAACGTCAAGCGTCTGT
AGCTTCTTAGGATAACTCGG -> GCTTCTTAGGATAACTCGGT
TCATCCCCAGCTTCTAACCT -> CATCCCCAGCTTCTAACCTA
GGACCCTCGCCCGAGCTCCC -> GACCCTCGCCCGAGCTCCCT
GCGTTTGAGAGCAGAGGGCT -> CGTTTGAGAGCAGAGGGCTG
GAAACAGGCTACCTCCGTTT -> AAACAGGCTACCTCCGTTTA
ATATGGTTGAAGTATCGGGG -> TATGGTTGAAGTATCGGGGA
GAGTCCAGACCCAATGCAGA -> AGTCCAGACCCAATGCAGAT
TAAAAAAAACGATGGAGTCC -> AAAAAAAACGATGGAGTCCA
CTCCGTTTAAGCAGCCGTGC -> TCCGTTTAAGCAGCCGTGCA
GTTAACGGGTTCAATACAGA -> TTAACGGGTTCAATACAGAC
ACTTTTGAGCTAGGCTCGGG -> CTTTTGAGCTAGGCTCGGGT
CATCACTCTTACGAAGATTT -> ATCACTCTTACGAAGATTTA
TCAACTGTAGGCTGGACCCT -> CAACTGTAGGCTGGACCCTA
TTTTTCAGGCGGGCGTCCAG -> TTTTCAGGCGGGCGTCCAGG
TAAATCTGTAATATGGCACG -> AAATCTGTAATATGGCACGA
GACTCATCCCCAGCTTCTAA -> ACTCATCCCCAGCTTCTAAC
GTCCATTGAAAGGGGCACTT -> TCCATTGAAAGGGGCACTTC
ACAACAGAGTCCGATTCGGG -> CAACAGAGTCCGATTCGGGA
TTTGAGAGCAGAGGGCTGGT -> TTGAGAGCAGAGGGCTGGTT
CTTCTAACCTAGCCAACGTG -> TTCTAACCTAGCCAACGTGA
GTTGCGCCCTTAGGGCGCCA -> TTGCGCCCTTAGGGCGCCAA
ATCGCCGGGGTCGTTACGGA -> TCGCCGGGGTCGTTACGGAT
CTAACACCCTGGTCTGGTAT -> TAACACCCTGGTCTGGTATC
GACAACAGAGTCCGATTCGG -> ACAACAGAGTCCGATTCGGG
ACGTTAGACCTGTATCATCG -> CGTTAGACCTGTATCATCGT
TGATTGTAATCCCTTGACAA -> GATTGTAATCCCTTGACAAA
GGCACTTCCTAGTATATGGT -> GCACTTCCTAGTATATGGTT
GAGACGTTAGACCTGTATCA -> AGACGTTAGACCTGTATCAT
TTACGGTGTACTCCTCGCTC -> TACGGTGTACTCCTCGCTCC
GGCTCGGGTTCTCCGTTGAA -> GCTCGGGTTCTCCGTTGAAC
AAGTTGCGAGGGGGGTAACG -> AGTTGCGAGGGGGGTAACGT
TCCTGATTGGGCGAAGAACG -> CCTGATTGGGCGAAGAACGC
GGCTGGACCCTAGTGTCTGA -> GCTGGACCCTAGTGTCTGAA
AACTCGAAACAGGCTACCTC -> ACTCGAAACAGGCTACCTCC
GACCCTCGCCCGAGCTCCCT -> ACCCTCGCCCGAGCTCCCTC
GCTTATGACAACAGAGTCCG -> CTTATGACAACAGAGTCCGA
TCACTTCGGATTGTCACTTT -> CACTTCGGATTGTCACTTTT
AACGCGGCTTCTCGCCTTAC -> ACGCGGCTTCTCGCCTTACG
GTACGCATCGCCGGGGTCGT -> TACGCATCGCCGGGGTCGTT
GACTAGAGCTTCTACAGGCT -> ACTAGAGCTTCTACAGGCTT
CTTTTGAGCTAGGCTCGGGT -> TTTTGAGCTAGGCTCGGGTT
CAACTAACACCCTGGTCTGG -> AACTAACACCCTGGTCTGGT
TGCGTTTGAGAGCAGAGGGC -> GCGTTTGAGAGCAGAGGGCT
TCCGATTCGGGACCCTCGCC -> CCGATTCGGGACCCTCGCCC
ATTGTTGATGCTCGAAGCTT -> TTGTTGATGCTCGAAGCTTC
AGAGTCCGATTCGGGACCCT -> GAGTCCGATTCGGGACCCTC
GAGCGGTGCTGATCAGTGAT -> AGCGGTGCTGATCAGTGATT
ACCACGTTCAGACTCTGCAA -> CCACGTTCAGACTCTGCAAC
CTAGTGTCTGAACAGCCGCG -> TAGTGTCTGAACAGCCGCGC
CGGGACCCTCGCCCGAGCTC -> GGGACCCTCGCCCGAGCTCC
GATCCCCGTCTGAAAAGAGG -> ATCCCCGTCTGAAAAGAGGG
GTGTTTTACCTCACTTCGGA -> TGTTTTACCTCACTTCGGAT
GTGTGTTTTACCTCACTTCG -> TGTGTTTTACCTCACTTCGG
CTGGTCTGGTATCCTGATTG -> TGGTCTGGTATCCTGATTGG
CTCGACTAGAGCTTCTACAG -> TCGACTAGAGCTTCTACAGG
CTCGCTCCCTAGCCACTGGG -> TCGCTCCCTAGCCACTGGGA
TCATAACGCGGCTTCTCGCC -> CATAACGCGGCTTCTCGCCT
CGTTTGAGAGCAGAGGGCTG -> GTTTGAGAGCAGAGGGCTGG
ATGGAGTCCAGACCCAATGC -> TGGAGTCCAGACCCAATGCA
CAGCCGCGCGCGCGCCAGTC -> AGCCGCGCGCGCGCCAGTCC
GCTCCCTCAACTTAAGACTG -> CTCCCTCAACTTAAGACTGA
GCTTCTCGCCTTACGGTGTA -> CTTCTCGCCTTACGGTGTAC
AAAGAGACGTTAGACCTGTA -> AAGAGACGTTAGACCTGTAT
AAAGGGGCACTTCCTAGTAT -> AAGGGGCACTTCCTAGTATA
GATGCTCGAAGCTTCTTAGG -> ATGCTCGAAGCTTCTTAGGA
TTACGGATAAAAAAAACGAT -> TACGGATAAAAAAAACGATG
TGTAATATGGCACGAAAACA -> GTAATATGGCACGAAAACAG
TGTCACTTTTGAGCTAGGCT -> GTCACTTTTGAGCTAGGCTC
GTGTACTCCTCGCTCCCTAG -> TGTACTCCTCGCTCCCTAGC
AACGCAGTGCTGCTAATTGA -> ACGCAGTGCTGCTAATTGAC
ACTCGAAACAGGCTACCTCC -> CTCGAAACAGGCTACCTCCG
AAATCTGTAATATGGCACGA -> AATCTGTAATATGGCACGAA
CATTCAGCGACCACGTTCAG -> ATTCAGCGACCACGTTCAGA
CCTTACGGTGTACTCCTCGC -> CTTACGGTGTACTCCTCGCT
TGCGAAGTGAGCGGTGCTGA -> GCGAAGTGAGCGGTGCTGAT
AAAGAGGGATACTGCCGCAT -> AAGAGGGATACTGCCGCATC
CTTATGACAACAGAGTCCGA -> TTATGACAACAGAGTCCGAT
AGCGTCTGTTAACGGGTTCA -> GCGTCTGTTAACGGGTTCAA
ACACCCTGGTCTGGTATCCT -> CACCCTGGTCTGGTATCCTG
GCGTAAATCTGTAATATGGC -> CGTAAATCTGTAATATGGCA
TTCTCCGTTGAACATCACTC -> TCTCCGTTGAACATCACTCT
AGTAGTCGAAACCCAACAAT -> GTAGTCGAAACCCAACAATG
GCACTTCCTAGTATATGGTT -> CACTTCCTAGTATATGGTTG
GGCTTATGACAACAGAGTCC -> GCTTATGACAACAGAGTCCG
GTAACGTCAAGCGTCTGTTA -> TAACGTCAAGCGTCTGTTAA
GTTTTACCTCACTTCGGATT -> TTTTACCTCACTTCGGATTG
GTTTGAGAGCAGAGGGCTGG -> TTTGAGAGCAGAGGGCTGGT
GCAGTGCTGCTAATTGACTC -> CAGTGCTGCTAATTGACTCT
ACTTCGGATTGTCACTTTTG -> CTTCGGATTGTCACTTTTGA
AGAGTAATGTGGTTGCGTTA -> GAGTAATGTGGTTGCGTTAA
CGACCACGTTCAGACTCTGC -> GACCACGTTCAGACTCTGCA
AGGCTCGGGTTCTCCGTTGA -> GGCTCGGGTTCTCCGTTGAA
CCAACAATGCAAACAACTCG -> CAACAATGCAAACAACTCGA
GGGGAAGAGTGTACGCATCG -> GGGAAGAGTGTACGCATCGC
CTCCTCGCTCCCTAGCCACT -> TCCTCGCTCCCTAGCCACTG
GTTGATGCTCGAAGCTTCTT -> TTGATGCTCGAAGCTTCTTA
CGCGCGCGCCAGTCCGCCCA -> GCGCGCGCCAGTCCGCCCAA
TAATATGGCACGAAAACAGT -> AATATGGCACGAAAACAGTG
TGAAACAGTTATGTCGCAGG -> GAAACAGTTATGTCGCAGGC
AGAACGCCCTACCACCGTTA -> GAACGCCCTACCACCGTTAC
ATCAACTGTAGGCTGGACCC -> TCAACTGTAGGCTGGACCCT
ACACCTCGACTAGAGCTTCT -> CACCTCGACTAGAGCTTCTA
TACAGGCTTATGACAACAGA -> ACAGGCTTATGACAACAGAG
GCCCAACATATTCATTCAGC -> CCCAACATATTCATTCAGCG
ATTCAGCGACCACGTTCAGA -> TTCAGCGACCACGTTCAGAC
AACAGTGCGGGAAAAGTTGC -> ACAGTGCGGGAAAAGTTGCG
CGATTCGGGACCCTCGCCCG -> GATTCGGGACCCTCGCCCGA
TCACTTTTGAGCTAGGCTCG -> CACTTTTGAGCTAGGCTCGG
AGTTATGTCGCAGGCGTAAA -> GTTATGTCGCAGGCGTAAAT
TGTTGATGCTCGAAGCTTCT -> GTTGATGCTCGAAGCTTCTT
AGGCGTAAATCTGTAATATG -> GGCGTAAATCTGTAATATGG
AAAAGTTGCGAGGGGGGTAA -> AAAGTTGCGAGGGGGGTAAC
CAGTGCGGGAAAAGTTGCGA -> AGTGCGGGAAAAGTTGCGAG
AATTGTTGATGCTCGAAGCT -> ATTGTTGATGCTCGAAGCTT
TGTCGCAGGCGTAAATCTGT -> GTCGCAGGCGTAAATCTGTA
CTCAACTTAAGACTGACTCA -> TCAACTTAAGACTGACTCAT
TCATCGTGTGTTTTACCTCA -> CATCGTGTGTTTTACCTCAC
TGTTGCGCCCTTAGGGCGCC -> GTTGCGCCCTTAGGGCGCCA
GAGGGATACTGCCGCATCTA -> AGGGATACTGCCGCATCTAG
ATCACTCTTACGAAGATTTA -> TCACTCTTACGAAGATTTAT
GTCACTTTTGAGCTAGGCTC -> TCACTTTTGAGCTAGGCTCG
TAATGTGGTTGCGTTAAGTA -> AATGTGGTTGCGTTAAGTAG
TTTTACCTCACTTCGGATTG -> TTTACCTCACTTCGGATTGT
GTCCGCCCAACATATTCATT -> TCCGCCCAACATATTCATTC
GCCCTTAGGGCGCCAACTGG -> CCCTTAGGGCGCCAACTGGA
TAGTATATGGTTGAAGTATC -> AGTATATGGTTGAAGTATCG
ACTTGGGGTGCGAAGTGAGC -> CTTGGGGTGCGAAGTGAGCG
CCCTAGTGTCTGAACAGCCG -> CCTAGTGTCTGAACAGCCGC
CTACATTTTTTCAGGCGGGC -> TACATTTTTTCAGGCGGGCG
AGAGGGATACTGCCGCATCT -> GAGGGATACTGCCGCATCTA
CTACCACCGTTACTGAAACA -> TACCACCGTTACTGAAACAG
ACAAAATTGTTGATGCTCGA -> CAAAATTGTTGATGCTCGAA
TGCAAACAACTCGAAACAGG -> GCAAACAACTCGAAACAGGC
AGAGCAGAGGGCTGGTTAAA -> GAGCAGAGGGCTGGTTAAAG
TATCCTGATTGGGCGAAGAA -> ATCCTGATTGGGCGAAGAAC
GTTCTCGCAGAATCTATCAC -> TTCTCGCAGAATCTATCACT
GTATCCTGATTGGGCGAAGA -> TATCCTGATTGGGCGAAGAA
