AAAGAGGCCGCTGAGCGTT -> AAGAGGCCGCTGAGCGTTG
CTTCTGAACTATGCGCTTC -> TTCTGAACTATGCGCTTCA
GAGGACTTATTACAATGCC -> AGGACTTATTACAATGCCT
CCGCGAGCGTCTCACTAGA -> CGCGAGCGTCTCACTAGAA
GAGCGGCTATCCATAATTC -> AGCGGCTATCCATAATTCA
TTACTGGGCGTGACATTGC -> TACTGGGCGTGACATTGCT
GGAAGCCAGACAGCTCTTA -> GAAGCCAGACAGCTCTTAT
AGCCATTCGAGAAGTTCCC -> GCCATTCGAGAAGTTCCCT
TTCTCGATGGAATCGCTGT -> TCTCGATGGAATCGCTGTA
CCGATCGCCCGCGTGGGGT -> CGATCGCCCGCGTGGGGTA
CGCACCTAGTTTGCCTGAA -> GCACCTAGTTTGCCTGAAC
TCGCTGTAATTTTATCCTA -> CGCTGTAATTTTATCCTAA
ATCGCTGTAATTTTATCCT -> TCGCTGTAATTTTATCCTA
GCGTCCCTGCATAATTCAT -> CGTCCCTGCATAATTCATA
CCGTCATAATTCATACCGC -> CGTCATAATTCATACCGCA
CCACTTTTCTGTACTCTAA -> CACTTTTCTGTACTCTAAC
CTCAGGGCACCTTCCCGTC -> TCAGGGCACCTTCCCGTCA
ACCGCAAACGGTCCTGATC -> CCGCAAACGGTCCTGATCG
ATTCGAGAAGTTCCCTCAG -> TTCGAGAAGTTCCCTCAGA
CCCGCGTGGGGTACGCTCG -> CCGCGTGGGGTACGCTCGG
CAGAGAATTGCTCGAACGA -> AGAGAATTGCTCGAACGAG
GATTACTGGGCGTGACATT -> ATTACTGGGCGTGACATTG
TACCCGATCGCCCGCGTGG -> ACCCGATCGCCCGCGTGGG
TCCGCCCGTCTGTGCATTA -> CCGCCCGTCTGTGCATTAC
TTATGTATATTAGTCCGTT -> TATGTATATTAGTCCGTTG
GGTGAACCATAATTCATAC -> GTGAACCATAATTCATACC
CCCACGATATCGCTTTGTT -> CCACGATATCGCTTTGTTG
ACCGTTTCCTTCATGTTAG -> CCGTTTCCTTCATGTTAGC
GTAATTCAAGATCTAACCC -> TAATTCAAGATCTAACCCG
AAGCTGCCGAGGCAGAGGC -> AGCTGCCGAGGCAGAGGCG
GGAGCATAAGTTTCTGCGT -> GAGCATAAGTTTCTGCGTT
TACAATGCCTCAATGGAGG -> ACAATGCCTCAATGGAGGG
AAAAGTTATTACGTGGATA -> AAAGTTATTACGTGGATAT
CCTTCATGTTAGCTACATC -> CTTCATGTTAGCTACATCT
TTCCTTCATGTTAGCTACA -> TCCTTCATGTTAGCTACAT
ACGTCTGTGCGGAGTCTAG -> CGTCTGTGCGGAGTCTAGA
CCCTCCTGTTCGGCACAGC -> CCTCCTGTTCGGCACAGCT
AAGCTGTCTTCAACGGGCA -> AGCTGTCTTCAACGGGCAC
GTCCACATTTAAAAACTTC -> TCCACATTTAAAAACTTCT
GTGGATATCACCTCAATAC -> TGGATATCACCTCAATACT
ACCATGGCGTACTCGTGCA -> CCATGGCGTACTCGTGCAA
AGTTTCTGCGTTCAATTAT -> GTTTCTGCGTTCAATTATC
TTGCGTAGTAAATTTATGG -> TGCGTAGTAAATTTATGGC
CAACGGGCACGGGGAGCAT -> AACGGGCACGGGGAGCATA
CGCCTAGCAGCTGAATATC -> GCCTAGCAGCTGAATATCC
TCGCGAAAAGAGGATGGCG -> CGCGAAAAGAGGATGGCGC
CTAGAATGCGAGTTGCCGA -> TAGAATGCGAGTTGCCGAA
CTGGAGCGCTTTAAAACTA -> TGGAGCGCTTTAAAACTAC
GTCGTCAGCAGAATGCGAG -> TCGTCAGCAGAATGCGAGT
GTCTATCACCTAAGACGTT -> TCTATCACCTAAGACGTTG
CAGAGGCGGTCGGGTGAGC -> AGAGGCGGTCGGGTGAGCA
ATCGTAACATGTGTAGACA -> TCGTAACATGTGTAGACAC
GGCTAGTTGCCTACCTTCT -> GCTAGTTGCCTACCTTCTG
GCGAGGGTAAATCAATTCA -> CGAGGGTAAATCAATTCAT
ATACCGCAAACTTGTCCAC -> TACCGCAAACTTGTCCACA
ACGTTGGAAGCCAGACAGC -> CGTTGGAAGCCAGACAGCT
ATAAGTTTCTGCGTTCAAT -> TAAGTTTCTGCGTTCAATT
CGTTTCCTTCATGTTAGCT -> GTTTCCTTCATGTTAGCTA
GTTTGCCTGAACTATCGTG -> TTTGCCTGAACTATCGTGC
TGCATCTATCCTCAGAGAA -> GCATCTATCCTCAGAGAAA
TGACGTTTGATTACCTCCG -> GACGTTTGATTACCTCCGT
GCACCTTCCCGTCAAGGAA -> CACCTTCCCGTCAAGGAAC
AAGACGTTGGAAGCCAGAC -> AGACGTTGGAAGCCAGACA
GGTCCCGCAGATTCATCCG -> GTCCCGCAGATTCATCCGG
CATAAACGTGCGGTTCTTA -> ATAAACGTGCGGTTCTTAG
ATGTATATTAGTCCGTTGC -> TGTATATTAGTCCGTTGCC
CCGCAAACACGTATTTAAT -> CGCAAACACGTATTTAATC
AGCCAGAGCCTGGCTGAGA -> GCCAGAGCCTGGCTGAGAC
AGCTAACCTACCTTCTGAA -> GCTAACCTACCTTCTGAAC
GCAAACTTGTCCACATTTA -> CAAACTTGTCCACATTTAA
GGTAATAGACGTTATTAGT -> GTAATAGACGTTATTAGTA
TGCAGTCAGGTTAAGCTGC -> GCAGTCAGGTTAAGCTGCC
GTTCCCTCAGAGCCAGAGC -> TTCCCTCAGAGCCAGAGCC
AAGTTAAACAAGGCAGACG -> AGTTAAACAAGGCAGACGC
TTAGTACGTCCGTGTGCCC -> TAGTACGTCCGTGTGCCCT
GATGTGAGTTGAGTGCGAA -> ATGTGAGTTGAGTGCGAAC
GTTAGCTACATCTGAGTTG -> TTAGCTACATCTGAGTTGC
AACGGTCCTGATCGTAACA -> ACGGTCCTGATCGTAACAT
AGACGGCGACTAGCTACAT -> GACGGCGACTAGCTACATT
AGCGCTTTAAAACTACACT -> GCGCTTTAAAACTACACTG
TCACGGAATCTTAATTGTT -> CACGGAATCTTAATTGTTA
ATACCGCAAACACGTATTT -> TACCGCAAACACGTATTTA
GGCGCTTATAGAGGTCACA -> GCGCTTATAGAGGTCACAG
CCTCAGAGAAAACCGGTAA -> CTCAGAGAAAACCGGTAAT
GTTGCTTTAGCGCAGCTAA -> TTGCTTTAGCGCAGCTAAC
TGATCGTAACATGTGTAGA -> GATCGTAACATGTGTAGAC
GAATGCGAGTTGCCGAACT -> AATGCGAGTTGCCGAACTA
ACATTATGTATATTAGTCC -> CATTATGTATATTAGTCCG
TCTGAACTATGACGGGGTG -> CTGAACTATGACGGGGTGA
CGCTGGGGAATTAGTAACG -> GCTGGGGAATTAGTAACGC
AGATCCAATTGCCAGAGGA -> GATCCAATTGCCAGAGGAC
AACGTGCGGTTCTTAGTAC -> ACGTGCGGTTCTTAGTACG
GGGAGCATAAGTTTCTGCG -> GGAGCATAAGTTTCTGCGT
ATTCAAGATCTAACCCGCA -> TTCAAGATCTAACCCGCAC
AACGTGAAGTTGCTGTAAT -> ACGTGAAGTTGCTGTAATG
TAATTCATACCGCAAACGT -> AATTCATACCGCAAACGTG
ACTTGGGCACCGATGGTTC -> CTTGGGCACCGATGGTTCC
TTTTCTGTACTCTAACTTG -> TTTCTGTACTCTAACTTGG
CACGTCTGTGCGGAGTCTA -> ACGTCTGTGCGGAGTCTAG
CCAGAGCCTGGCTGAGACC -> CAGAGCCTGGCTGAGACCT
GTACCATAAACGTGCGGTT -> TACCATAAACGTGCGGTTC
CGTAGTAAATTTATGGCAA -> GTAGTAAATTTATGGCAAG
GAGCAAACGGCGTGCTCCA -> AGCAAACGGCGTGCTCCAA
CACCTAAGACGTTGGAAGC -> ACCTAAGACGTTGGAAGCC
GTAATTTTATCCTAACGAA -> TAATTTTATCCTAACGAAC
CATTACGATGAAACCGCGA -> ATTACGATGAAACCGCGAG
GCGATCCCTTAGAAGTTAA -> CGATCCCTTAGAAGTTAAA
TACTTGTGCAATACTCTTG -> ACTTGTGCAATACTCTTGG
ATGCGTGTCTAAAGGGCCT -> TGCGTGTCTAAAGGGCCTC
TATAGAGGTCACAGTGCTG -> ATAGAGGTCACAGTGCTGA
GTGACCCTCACCAGCACGC -> TGACCCTCACCAGCACGCT
ATCCAATTGCCAGAGGACT -> TCCAATTGCCAGAGGACTG
TTGCCGAACTAAATGACGG -> TGCCGAACTAAATGACGGT
CAATAATTTTCAAAAGTTA -> AATAATTTTCAAAAGTTAT
CGTCATAATTCATACCGCA -> GTCATAATTCATACCGCAA
CTGATGGCGTACTGCATCT -> TGATGGCGTACTGCATCTA
TGGGGAATTAGTAACGCGC -> GGGGAATTAGTAACGCGCC
GTCCTTCTGCTGCAGTCAG -> TCCTTCTGCTGCAGTCAGG
GAGCCAGAGCCTGGCTGAG -> AGCCAGAGCCTGGCTGAGA
ATGCGAGTGGCTAGTTGCC -> TGCGAGTGGCTAGTTGCCT
GCTCGGTCCCGCAGATTCA -> CTCGGTCCCGCAGATTCAT
AAACTTGTCCACATTTAAA -> AACTTGTCCACATTTAAAA
CGATTCCCTACCTTCTGAA -> GATTCCCTACCTTCTGAAC
CGGAGGCATCCATTCCCCC -> GGAGGCATCCATTCCCCCC
GAGCGTTGCTTTAGCGCAG -> AGCGTTGCTTTAGCGCAGC
GGACCGCCGTGCGCCTCGG -> GACCGCCGTGCGCCTCGGT
CAGCTCTTATACACCGCTA -> AGCTCTTATACACCGCTAG
AATCGCTGTAATTTTATCC -> ATCGCTGTAATTTTATCCT
CAGCTGAATATCCCAGAGC -> AGCTGAATATCCCAGAGCT
ACAGAGAATTGCTCGAACG -> CAGAGAATTGCTCGAACGA
TGCTGGAAACCTTACGGAT -> GCTGGAAACCTTACGGATA
TGCGGAGTCTAGACTGGTG -> GCGGAGTCTAGACTGGTGT
TATTACGTGGATATCACCT -> ATTACGTGGATATCACCTC
AATCCTCGTGCGAAGAGCA -> ATCCTCGTGCGAAGAGCAT
CGTTGGAAGCCAGACAGCT -> GTTGGAAGCCAGACAGCTC
CAGTGCTGAGGGTTGTTCG -> AGTGCTGAGGGTTGTTCGC
TGTGACCCTCACCAGCACG -> GTGACCCTCACCAGCACGC
CTAACGAACAATTTTGGCC -> TAACGAACAATTTTGGCCG
GAGAGTCTATCACCTAAGA -> AGAGTCTATCACCTAAGAC
ATTTTCAAAAGTTATTACG -> TTTTCAAAAGTTATTACGT
CGTGGACCGCCGTGCGCCT -> GTGGACCGCCGTGCGCCTC
ACCTTCTGAACTATGACGG -> CCTTCTGAACTATGACGGG
GGGTTCCGCCCGTCTGTGC -> GGTTCCGCCCGTCTGTGCA
TTAGTCCGTTGCCGAAATC -> TAGTCCGTTGCCGAAATCG
ACCGTGACCATGGCGTACT -> CCGTGACCATGGCGTACTC
CACAGTGCTGAGGGTTGTT -> ACAGTGCTGAGGGTTGTTC
AATTGCTCGAACGAGTGAC -> ATTGCTCGAACGAGTGACG
CTTATACCCGATCGCCCGC -> TTATACCCGATCGCCCGCG
GACTGGTGTTTCATGTCGT -> ACTGGTGTTTCATGTCGTC
TTACGATGAAACCGCGAGC -> TACGATGAAACCGCGAGCG
TGGAAGCCAGACAGCTCTT -> GGAAGCCAGACAGCTCTTA
CATCAGTATGGCATCGAGC -> ATCAGTATGGCATCGAGCA
CGGTTTGTACTAACGGAGG -> GGTTTGTACTAACGGAGGC
TCTGACGGCGGAGGACTTA -> CTGACGGCGGAGGACTTAT
TTGCTCAGGGCACCTTCCC -> TGCTCAGGGCACCTTCCCG
AGTGACGCCACTTTTCTGT -> GTGACGCCACTTTTCTGTA
CGGTCCTGATCGTAACATG -> GGTCCTGATCGTAACATGT
ACTACAGCGCTCCTACCCC -> CTACAGCGCTCCTACCCCA
TCGGCACAGCTGGCTCGCA -> CGGCACAGCTGGCTCGCAA
CGTGCAAAGATCCAATTGC -> GTGCAAAGATCCAATTGCC
TATGTCGCGTCCCTGCATA -> ATGTCGCGTCCCTGCATAA
CTGCATAATTCATACCGCA -> TGCATAATTCATACCGCAA
AATAGACGTTATTAGTACG -> ATAGACGTTATTAGTACGT
GGATATTCCCCTTACATAG -> GATATTCCCCTTACATAGT
GCGAACTGTGGGACAATAT -> CGAACTGTGGGACAATATA
TTACAATGCCTCAATGGAG -> TACAATGCCTCAATGGAGG
ATCCATAATTCATACCGCA -> TCCATAATTCATACCGCAA
AGTCTATCACCTAAGACGT -> GTCTATCACCTAAGACGTT
ACTTATTACAATGCCTCAA -> CTTATTACAATGCCTCAAT
GCTTTAAAACTACACTGCT -> CTTTAAAACTACACTGCTG
ACTGTCCAAGTTGGTTGAG -> CTGTCCAAGTTGGTTGAGG
GAGGATGGCGCGCCTATAC -> AGGATGGCGCGCCTATACT
GTGAGTTGAGTGCGAACTG -> TGAGTTGAGTGCGAACTGT
ATTCATCCGGCAAAGAGGC -> TTCATCCGGCAAAGAGGCC
AGCGCTCCTACCCCAATAA -> GCGCTCCTACCCCAATAAT
TGCTATTTTCGGATGGATA -> GCTATTTTCGGATGGATAC
GGAACCGTGACCATGGCGT -> GAACCGTGACCATGGCGTA
GTGCAAGCTGTCTTCAACG -> TGCAAGCTGTCTTCAACGG
CTGGCTCGCAACCGCACCT -> TGGCTCGCAACCGCACCTA
TGGCATCGAGCACCTGGAG -> GGCATCGAGCACCTGGAGC
ACTATGTCGCGTCCCTGCA -> CTATGTCGCGTCCCTGCAT
TACACCGCTAGATAGTGCA -> ACACCGCTAGATAGTGCAG
CCGCAAACGTGAAGTTGCT -> CGCAAACGTGAAGTTGCTG
CCTGTGTTACCGTCCGCGA -> CTGTGTTACCGTCCGCGAT
TCCGCGATCCCTTAGAAGT -> CCGCGATCCCTTAGAAGTT
TTCCAGTACCGTTTCCTTC -> TCCAGTACCGTTTCCTTCA
GCGCAGCTAACCTACCTTC -> CGCAGCTAACCTACCTTCT
TACATCAGCTGTGCCATAA -> ACATCAGCTGTGCCATAAC
ATACATCCGTGCCTTGGAA -> TACATCCGTGCCTTGGAAA
CAAACACGTATTTAATCAG -> AAACACGTATTTAATCAGA
TCTTAATTGTTATTTGTAA -> CTTAATTGTTATTTGTAAG
CCAGTACCGTTTCCTTCAT -> CAGTACCGTTTCCTTCATG
CATAATTCATACCGCAAAC -> ATAATTCATACCGCAAACG,ATAATTCATACCGCAAACT,ATAATTCATACCGCAAACA,ATAATTCATACCGCAAACG
GCGAAAAGAGGATGGCGCG -> CGAAAAGAGGATGGCGCGC
CCGTACCATAAACGTGCGG -> CGTACCATAAACGTGCGGT
CAAGGACCTGTGTTACCGT -> AAGGACCTGTGTTACCGTC
CCTTACGGATATTCCCCTT -> CTTACGGATATTCCCCTTA
GAGCGTCTCACTAGAATGC -> AGCGTCTCACTAGAATGCG
ATCTAACCCGCACATCGAG -> TCTAACCCGCACATCGAGA
ATTTAAAAACTTCTGAATG -> TTTAAAAACTTCTGAATGC
CCCTACGCCTAGCAGCTGA -> CCTACGCCTAGCAGCTGAA
TCGCAACCGCACCTAGTTT -> CGCAACCGCACCTAGTTTG
CTAAATGACGGTTTGTACT -> TAAATGACGGTTTGTACTA
GGCACGGGGAGCATAAGTT -> GCACGGGGAGCATAAGTTT
TCCCTTAGAAGTTAAACAA -> CCCTTAGAAGTTAAACAAG
TTCATACCGCAAACACGTA -> TCATACCGCAAACACGTAT
TAACCTACCTTCTGAACTA -> AACCTACCTTCTGAACTAT
GGAGGCGCGTTTTGTAACA -> GAGGCGCGTTTTGTAACAC
CATCCGTGCCTTGGAAATG -> ATCCGTGCCTTGGAAATGA
CCTCCTGTTCGGCACAGCT -> CTCCTGTTCGGCACAGCTG
ATACACCGCTAGATAGTGC -> TACACCGCTAGATAGTGCA
GCTGTCTTCAACGGGCACG -> CTGTCTTCAACGGGCACGG
TGACATTGCTCAGGGCACC -> GACATTGCTCAGGGCACCT
CTGTGCCATAACCCTCCTG -> TGTGCCATAACCCTCCTGT
GTAATAGACGTTATTAGTA -> TAATAGACGTTATTAGTAC
TAGATAGTGCAGGGCTGGG -> AGATAGTGCAGGGCTGGGC
CTCGTCATCCTACAGAGAA -> TCGTCATCCTACAGAGAAT
TATGACGCGATTACTGGGC -> ATGACGCGATTACTGGGCG
ACATTGCTCAGGGCACCTT -> CATTGCTCAGGGCACCTTC
CTAACCCGCACATCGAGAG -> TAACCCGCACATCGAGAGT
GATTCCCTACCTTCTGAAC -> ATTCCCTACCTTCTGAACT
CCGAGGCAGAGGCGGTCGG -> CGAGGCAGAGGCGGTCGGG
GTTGATAATCGTTGAATCA -> TTGATAATCGTTGAATCAC
AATTCATATCTGTCGGGAG -> ATTCATATCTGTCGGGAGT
GAAATGAGGAGGCGCGTTT -> AAATGAGGAGGCGCGTTTT
AACGTTCCAGTACCGTTTC -> ACGTTCCAGTACCGTTTCC
AAACACGTATTTAATCAGA -> AACACGTATTTAATCAGAC
AATCAATTCATATCTGTCG -> ATCAATTCATATCTGTCGG
ATTATGTATATTAGTCCGT -> TTATGTATATTAGTCCGTT
CCGCAGATTCATCCGGCAA -> CGCAGATTCATCCGGCAAA
AATCCTCAGGTCCTTCTGC -> ATCCTCAGGTCCTTCTGCT
GTCCGCGATCCCTTAGAAG -> TCCGCGATCCCTTAGAAGT
AGTGCGAACTGTGGGACAA -> GTGCGAACTGTGGGACAAT
GCGTGTCTAAAGGGCCTCA -> CGTGTCTAAAGGGCCTCAC
TTGCCTGAACTATCGTGCA -> TGCCTGAACTATCGTGCAA
TACCGCAAACGTGAAGTTG -> ACCGCAAACGTGAAGTTGC
GCGACTAGCTACATTATGT -> CGACTAGCTACATTATGTA
ATGCGAGTTGCCGAACTAA -> TGCGAGTTGCCGAACTAAA
CGTAATTCAAGATCTAACC -> GTAATTCAAGATCTAACCC
ACTCTTGGCGAGGGTAAAT -> CTCTTGGCGAGGGTAAATC
GGCAGACGCTTCGTATAGA -> GCAGACGCTTCGTATAGAG
TAGAATGCGAGTTGCCGAA -> AGAATGCGAGTTGCCGAAC
CTTCTCGATGGAATCGCTG -> TTCTCGATGGAATCGCTGT
CACCTTCCCGTCAAGGAAC -> ACCTTCCCGTCAAGGAACG
TCATTGAGGTGCGTAATTC -> CATTGAGGTGCGTAATTCA
GAAGTTGCTGTAATGCTAT -> AAGTTGCTGTAATGCTATT
TGAGTTGCGAATGGCGCTT -> GAGTTGCGAATGGCGCTTA
GCGCGTTTTGTAACACGTC -> CGCGTTTTGTAACACGTCT
TATTAGTACGTCCGTGTGC -> ATTAGTACGTCCGTGTGCC
AGCTGAATATCCCAGAGCT -> GCTGAATATCCCAGAGCTT
TACTCGTGCAAGCTGTCTT -> ACTCGTGCAAGCTGTCTTC
GCCTTGGAAATGAGGAGGC -> CCTTGGAAATGAGGAGGCG
CGAGCGTCTCACTAGAATG -> GAGCGTCTCACTAGAATGC
ACCTACCTTCTGAACTATG -> CCTACCTTCTGAACTATGA
CAACCGTGGACCGCCGTGC -> AACCGTGGACCGCCGTGCG
TTATGACGCGATTACTGGG -> TATGACGCGATTACTGGGC
GCCTCACGGTACCGAGGTA -> CCTCACGGTACCGAGGTAG
CTTGTGCAATACTCTTGGC -> TTGTGCAATACTCTTGGCG
ATTCCCCTTACATAGTCAT -> TTCCCCTTACATAGTCATG
TAAAAACTTCTGAATGCTG -> AAAAACTTCTGAATGCTGC
CTGCAGTCAGGTTAAGCTG -> TGCAGTCAGGTTAAGCTGC
GGAAATGAGGAGGCGCGTT -> GAAATGAGGAGGCGCGTTT
TCTGAGTTGCGAATGGCGC -> CTGAGTTGCGAATGGCGCT
GCTTATAGAGGTCACAGTG -> CTTATAGAGGTCACAGTGC
CGAGAGTCTATCACCTAAG -> GAGAGTCTATCACCTAAGA
ATATCTGTCGGGAGTTCAC -> TATCTGTCGGGAGTTCACC
AGTTCCCTCAGAGCCAGAG -> GTTCCCTCAGAGCCAGAGC
GGCCGCTGAGCGTTGCTTT -> GCCGCTGAGCGTTGCTTTA
TGCCTCCCGTGCCCACGAT -> GCCTCCCGTGCCCACGATA
CTCACCAGCACGCTGGGGA -> TCACCAGCACGCTGGGGAA
GCGGAGGACTTATTACAAT -> CGGAGGACTTATTACAATG
CCGTCCGCGATCCCTTAGA -> CGTCCGCGATCCCTTAGAA
GATTCGTCTATGAGAATTG -> ATTCGTCTATGAGAATTGC
CCTAACGAACAATTTTGGC -> CTAACGAACAATTTTGGCC
GCGGAGTCTAGACTGGTGT -> CGGAGTCTAGACTGGTGTT
TATGTATATTAGTCCGTTG -> ATGTATATTAGTCCGTTGC
CAAGGAACGTTCCAGTACC -> AAGGAACGTTCCAGTACCG
TAAGACGTTGGAAGCCAGA -> AAGACGTTGGAAGCCAGAC
CGTGGGGTACGCTCGGTCC -> GTGGGGTACGCTCGGTCCC
CTTGGGCACCGATGGTTCC -> TTGGGCACCGATGGTTCCT
TTTGTACTAACGGAGGCAT -> TTGTACTAACGGAGGCATC
AAGTTGCTGTAATGCTATT -> AGTTGCTGTAATGCTATTT
CAGTATGGGCGCAATATCT -> AGTATGGGCGCAATATCTC
TCAGCAGAATGCGAGTGGC -> CAGCAGAATGCGAGTGGCT
GAATCTTAATTGTTATTTG -> AATCTTAATTGTTATTTGT
AGCGTCTCACTAGAATGCG -> GCGTCTCACTAGAATGCGA
GCACCTAGTTTGCCTGAAC -> CACCTAGTTTGCCTGAACT
CTTATACACCGCTAGATAG -> TTATACACCGCTAGATAGT
CAGCAGTATGGGCGCAATA -> AGCAGTATGGGCGCAATAT
TTCGGATGGATACATCCGT -> TCGGATGGATACATCCGTG
AGGAGGCGCGTTTTGTAAC -> GGAGGCGCGTTTTGTAACA
CGTGACATTGCTCAGGGCA -> GTGACATTGCTCAGGGCAC
CGCAATATCTCCAGCATGA -> GCAATATCTCCAGCATGAA
TCCAGTACCGTTTCCTTCA -> CCAGTACCGTTTCCTTCAT
GGCGACTAGCTACATTATG -> GCGACTAGCTACATTATGT
CGACGCGTATCAATCCTCA -> GACGCGTATCAATCCTCAG
ATTTTCGGATGGATACATC -> TTTTCGGATGGATACATCC
TGATTACCTCCGTACCATA -> GATTACCTCCGTACCATAA
TGCCGAACTAAATGACGGT -> GCCGAACTAAATGACGGTT
CCAGACAGCTCTTATACAC -> CAGACAGCTCTTATACACC
TTACCGTCCGCGATCCCTT -> TACCGTCCGCGATCCCTTA
CTCTAACTTGGGCACCGAT -> TCTAACTTGGGCACCGATG
GTGCGTAATTCAAGATCTA -> TGCGTAATTCAAGATCTAA
ACGGATATTCCCCTTACAT -> CGGATATTCCCCTTACATA
CGCTAGATAGTGCAGGGCT -> GCTAGATAGTGCAGGGCTG
CGGTCGGGTGAGCAAACGG -> GGTCGGGTGAGCAAACGGC
CTATTTTCGGATGGATACA -> TATTTTCGGATGGATACAT
ATTTAATCAGACGGCGACT -> TTTAATCAGACGGCGACTA
ACCGTGGACCGCCGTGCGC -> CCGTGGACCGCCGTGCGCC
AAGGCAGACGCTTCGTATA -> AGGCAGACGCTTCGTATAG
ACGGCGTGCTCCAACCGTG -> CGGCGTGCTCCAACCGTGG
CGAGCACCTGGAGCGCTTT -> GAGCACCTGGAGCGCTTTA
TATGAGAATTGCACAATAA -> ATGAGAATTGCACAATAAC
CTTACGGATATTCCCCTTA -> TTACGGATATTCCCCTTAC
TATCACCTCAATACTTGTG -> ATCACCTCAATACTTGTGC
AATGACGGTTTGTACTAAC -> ATGACGGTTTGTACTAACG
GTGGCTAGTTGCCTACCTT -> TGGCTAGTTGCCTACCTTC
GAGGCATCCATTCCCCCCA -> AGGCATCCATTCCCCCCAA
TCATAATTCATACCGCAAA -> CATAATTCATACCGCAAAC
GGGCCTCACGGTACCGAGG -> GGCCTCACGGTACCGAGGT
TGTCTTCAACGGGCACGGG -> GTCTTCAACGGGCACGGGG
GAAGCCAGACAGCTCTTAT -> AAGCCAGACAGCTCTTATA
AGTATGGCATCGAGCACCT -> GTATGGCATCGAGCACCTG
CGTCATCCTACAGAGAATT -> GTCATCCTACAGAGAATTG
CCTCACCAGCACGCTGGGG -> CTCACCAGCACGCTGGGGA
AGGCAGAGCCATTCGAGAA -> GGCAGAGCCATTCGAGAAG
TCAGCCCTACGCCTAGCAG -> CAGCCCTACGCCTAGCAGC
TAGACTGGTGTTTCATGTC -> AGACTGGTGTTTCATGTCG
AGAATTGCTCGAACGAGTG -> GAATTGCTCGAACGAGTGA
GTCTGTGCATTACGATGAA -> TCTGTGCATTACGATGAAA
TAAACAAGGCAGACGCTTC -> AAACAAGGCAGACGCTTCG
ATTCATACCGCAAACGTGA -> TTCATACCGCAAACGTGAA
TAGCTTATAGCATGTCGTC -> AGCTTATAGCATGTCGTCA
CGCGAAAAGAGGATGGCGC -> GCGAAAAGAGGATGGCGCG
ATCTTAATTGTTATTTGTA -> TCTTAATTGTTATTTGTAA
AACATGTGTAGACACGATG -> ACATGTGTAGACACGATGC
ACGCCACTTTTCTGTACTC -> CGCCACTTTTCTGTACTCT
AGTATGGGCGCAATATCTC -> GTATGGGCGCAATATCTCC
GTCACAGTGCTGAGGGTTG -> TCACAGTGCTGAGGGTTGT
GACGTTTGATTACCTCCGT -> ACGTTTGATTACCTCCGTA
GCTCCAACCGTGGACCGCC -> CTCCAACCGTGGACCGCCG
TCACAGCAGTATGGGCGCA -> CACAGCAGTATGGGCGCAA
CCCCCAACAATTCCAGGAG -> CCCCAACAATTCCAGGAGG
AGGAGGCAGAGCCATTCGA -> GGAGGCAGAGCCATTCGAG
TGTACTCTAACTTGGGCAC -> GTACTCTAACTTGGGCACC
CGGGGAGCATAAGTTTCTG -> GGGGAGCATAAGTTTCTGC
CCTATACTACAGCGCTCCT -> CTATACTACAGCGCTCCTA
CGCCCGCGTGGGGTACGCT -> GCCCGCGTGGGGTACGCTC
ACGCCTAGCAGCTGAATAT -> CGCCTAGCAGCTGAATATC
GTCATGTGACCCTCACCAG -> TCATGTGACCCTCACCAGC
GAGAATTGCACAATAACAT -> AGAATTGCACAATAACATT
CAGATTCATCCGGCAAAGA -> AGATTCATCCGGCAAAGAG
TCGCTTTGTTGATAATCGT -> CGCTTTGTTGATAATCGTT
ATGAATCCTCGTGCGAAGA -> TGAATCCTCGTGCGAAGAG
CTGCGTTCAATTATCAGTC -> TGCGTTCAATTATCAGTCG
CCAATTGCCAGAGGACTGT -> CAATTGCCAGAGGACTGTC
CGCCTCGTCATCCTACAGA -> GCCTCGTCATCCTACAGAG
ATTTTGGCCGGTAATCACA -> TTTTGGCCGGTAATCACAG
ATAATTCATACCGCAAACG -> TAATTCATACCGCAAACGG,TAATTCATACCGCAAACGT
CACATCGAGAGTCTATCAC -> ACATCGAGAGTCTATCACC
CATTCTTATACCCGATCGC -> ATTCTTATACCCGATCGCC
ATGGCGCGCCTATACTACA -> TGGCGCGCCTATACTACAG
TGAATCCTCGTGCGAAGAG -> GAATCCTCGTGCGAAGAGC
GGTCCTTCTGCTGCAGTCA -> GTCCTTCTGCTGCAGTCAG
TCAGTCGATTCCCTACCTT -> CAGTCGATTCCCTACCTTC
TGAATATCCCAGAGCTTCT -> GAATATCCCAGAGCTTCTT
ATACCGCAAACGTGAAGTT -> TACCGCAAACGTGAAGTTG
CGCAGATTCATCCGGCAAA -> GCAGATTCATCCGGCAAAG
TGAGACCTGATTAGGGATT -> GAGACCTGATTAGGGATTG
CCTTCTGAACTATGTCGCG -> CTTCTGAACTATGTCGCGT
ATCCGGCAAAGAGGCCGCT -> TCCGGCAAAGAGGCCGCTG
AACCGCGAGCGTCTCACTA -> ACCGCGAGCGTCTCACTAG
ACTGTGGGACAATATACAT -> CTGTGGGACAATATACATC
CCCTAGCTTATAGCATGTC -> CCTAGCTTATAGCATGTCG
TAGCGCAGCTAACCTACCT -> AGCGCAGCTAACCTACCTT
CTCGAACGAGTGACGTTTG -> TCGAACGAGTGACGTTTGA
CTAACCTACCTTCTGAACT -> TAACCTACCTTCTGAACTA
CTACCTTCTGAACTATGCG -> TACCTTCTGAACTATGCGC
ACGGGGTGAACCATAATTC -> CGGGGTGAACCATAATTCA
TGGCAAGGACCTGTGTTAC -> GGCAAGGACCTGTGTTACC
TAAGTTTCTGCGTTCAATT -> AAGTTTCTGCGTTCAATTA
GCATGATAGAGGCACTGAT -> CATGATAGAGGCACTGATG
GTGACATTGCTCAGGGCAC -> TGACATTGCTCAGGGCACC
TTGTCCACATTTAAAAACT -> TGTCCACATTTAAAAACTT
TACATCCGTGCCTTGGAAA -> ACATCCGTGCCTTGGAAAT
CAGCCCTACGCCTAGCAGC -> AGCCCTACGCCTAGCAGCT
ACGTGAAGTTGCTGTAATG -> CGTGAAGTTGCTGTAATGC
GGATGGATACATCCGTGCC -> GATGGATACATCCGTGCCT
ATTGCTCGAACGAGTGACG -> TTGCTCGAACGAGTGACGT
AATGCTATTTTCGGATGGA -> ATGCTATTTTCGGATGGAT
GTGGGACAATATACATCAG -> TGGGACAATATACATCAGC
GGCAGAGCCATTCGAGAAG -> GCAGAGCCATTCGAGAAGT
CTGAGCGTTGCTTTAGCGC -> TGAGCGTTGCTTTAGCGCA
TAGTCCGTTGCCGAAATCG -> AGTCCGTTGCCGAAATCGT
ACAATAACATTCTTATACC -> CAATAACATTCTTATACCC
GAGGGTTGTTCGCGAAAAG -> AGGGTTGTTCGCGAAAAGA
GCATAAGTTTCTGCGTTCA -> CATAAGTTTCTGCGTTCAA
GTAGGATTCGTCTATGAGA -> TAGGATTCGTCTATGAGAA
TGTCTAAAGGGCCTCACGG -> GTCTAAAGGGCCTCACGGT
GAATGGCGCTTATAGAGGT -> AATGGCGCTTATAGAGGTC
TCAATTCATATCTGTCGGG -> CAATTCATATCTGTCGGGA
ACATAGTCATGTGACCCTC -> CATAGTCATGTGACCCTCA
GAAACCGCGAGCGTCTCAC -> AAACCGCGAGCGTCTCACT
GCCCGTCTGTGCATTACGA -> CCCGTCTGTGCATTACGAT
ATCGCCCGCGTGGGGTACG -> TCGCCCGCGTGGGGTACGC
AGCACGCTGGGGAATTAGT -> GCACGCTGGGGAATTAGTA
CGGTCCCGCAGATTCATCC -> GGTCCCGCAGATTCATCCG
CCATTCCCCCCAACAATTC -> CATTCCCCCCAACAATTCC
GCTGGCTCGCAACCGCACC -> CTGGCTCGCAACCGCACCT
CAATATACATCAGCTGTGC -> AATATACATCAGCTGTGCC
TGTTAGCTACATCTGAGTT -> GTTAGCTACATCTGAGTTG
TCTCACTAGAATGCGAGTT -> CTCACTAGAATGCGAGTTG
CGTCTCACTAGAATGCGAG -> GTCTCACTAGAATGCGAGT
TCCTACCCCAATAATTTTC -> CCTACCCCAATAATTTTCA
GTGCCCTAGCTTATAGCAT -> TGCCCTAGCTTATAGCATG
CTAGCAGCTGAATATCCCA -> TAGCAGCTGAATATCCCAG
CGTTGAATCACGGAATCTT -> GTTGAATCACGGAATCTTA
CTTGGCGAGGGTAAATCAA -> TTGGCGAGGGTAAATCAAT
GTCGCGTCCCTGCATAATT -> TCGCGTCCCTGCATAATTC
TCAATGGAGGGGTTCCGCC -> CAATGGAGGGGTTCCGCCC
AGGTCACAGTGCTGAGGGT -> GGTCACAGTGCTGAGGGTT
TAACCCGCACATCGAGAGT -> AACCCGCACATCGAGAGTC
TGCGTGTCTAAAGGGCCTC -> GCGTGTCTAAAGGGCCTCA
TACCGTTTCCTTCATGTTA -> ACCGTTTCCTTCATGTTAG
CGAAGAGCATGATAGAGGC -> GAAGAGCATGATAGAGGCA
ACCTTCTGAACTATGGAGC -> CCTTCTGAACTATGGAGCG
AAAACCGGTAATAGACGTT -> AAACCGGTAATAGACGTTA
AAAAACTTCTGAATGCTGC -> AAAACTTCTGAATGCTGCG
CGACTAGCTACATTATGTA -> GACTAGCTACATTATGTAT
ACGGCGGAGGACTTATTAC -> CGGCGGAGGACTTATTACA
GAATCCTCGTGCGAAGAGC -> AATCCTCGTGCGAAGAGCA
TCTTTGCGTAGTAAATTTA -> CTTTGCGTAGTAAATTTAT
GATGGAATCGCTGTAATTT -> ATGGAATCGCTGTAATTTT
GTCATAATTCATACCGCAA -> TCATAATTCATACCGCAAA
GCTGAATATCCCAGAGCTT -> CTGAATATCCCAGAGCTTC
AGGATTCGTCTATGAGAAT -> GGATTCGTCTATGAGAATT
GCTATTTTCGGATGGATAC -> CTATTTTCGGATGGATACA
GGTCGGGTGAGCAAACGGC -> GTCGGGTGAGCAAACGGCG
GGACTTATTACAATGCCTC -> GACTTATTACAATGCCTCA
CGCTGTAATTTTATCCTAA -> GCTGTAATTTTATCCTAAC
TACATTATGTATATTAGTC -> ACATTATGTATATTAGTCC
GTACTAACGGAGGCATCCA -> TACTAACGGAGGCATCCAT
ACCTTACGGATATTCCCCT -> CCTTACGGATATTCCCCTT
AATTATCAGTCGATTCCCT -> ATTATCAGTCGATTCCCTA
GCCGCTGAGCGTTGCTTTA -> CCGCTGAGCGTTGCTTTAG
GATTATGACGCGATTACTG -> ATTATGACGCGATTACTGG
CCGTGCCCACGATATCGCT -> CGTGCCCACGATATCGCTT
CGATGAAACCGCGAGCGTC -> GATGAAACCGCGAGCGTCT
TTCTGTACTCTAACTTGGG -> TCTGTACTCTAACTTGGGC
TCTAACCCGCACATCGAGA -> CTAACCCGCACATCGAGAG
AGCTGGCTCGCAACCGCAC -> GCTGGCTCGCAACCGCACC
GTATGGCATCGAGCACCTG -> TATGGCATCGAGCACCTGG
ATGTGACCCTCACCAGCAC -> TGTGACCCTCACCAGCACG
ACGTGCGGTTCTTAGTACG -> CGTGCGGTTCTTAGTACGA
TTGATTACCTCCGTACCAT -> TGATTACCTCCGTACCATA
AATGGAGGGGTTCCGCCCG -> ATGGAGGGGTTCCGCCCGT
TTTGGCCGGTAATCACAGC -> TTGGCCGGTAATCACAGCA
TCCTTCATGTTAGCTACAT -> CCTTCATGTTAGCTACATC
GAGGCCGCTGAGCGTTGCT -> AGGCCGCTGAGCGTTGCTT
ACACCGCTAGATAGTGCAG -> CACCGCTAGATAGTGCAGG
AAGTTGGTTGAGGAACCGT -> AGTTGGTTGAGGAACCGTG
GTCCCGCAGATTCATCCGG -> TCCCGCAGATTCATCCGGC
TCCTTCTGCTGCAGTCAGG -> CCTTCTGCTGCAGTCAGGT
CTATCGTGCAAAGATCCAA -> TATCGTGCAAAGATCCAAT
ACCTTCTGAACTATGTCGC -> CCTTCTGAACTATGTCGCG
GGCGTACTGCATCTATCCT -> GCGTACTGCATCTATCCTC
TCAGGTCCTTCTGCTGCAG -> CAGGTCCTTCTGCTGCAGT
TACGTGGATATCACCTCAA -> ACGTGGATATCACCTCAAT
TTTGTTGATAATCGTTGAA -> TTGTTGATAATCGTTGAAT
GCGAGTGGCTAGTTGCCTA -> CGAGTGGCTAGTTGCCTAC
TCTTATACACCGCTAGATA -> CTTATACACCGCTAGATAG
TTCATACCGCAAACGTGAA -> TCATACCGCAAACGTGAAG
TATACTACAGCGCTCCTAC -> ATACTACAGCGCTCCTACC
ATCGAGCACCTGGAGCGCT -> TCGAGCACCTGGAGCGCTT
CACTTTTCTGTACTCTAAC -> ACTTTTCTGTACTCTAACT
TACCTTCTGAACTATGCGC -> ACCTTCTGAACTATGCGCT
CTGATCGTAACATGTGTAG -> TGATCGTAACATGTGTAGA
TTGTTATTTGTAAGTGACG -> TGTTATTTGTAAGTGACGC
TACCGAGGTAGGATTCGTC -> ACCGAGGTAGGATTCGTCT
GAATGCGAGTGGCTAGTTG -> AATGCGAGTGGCTAGTTGC
AGATAGTGCAGGGCTGGGC -> GATAGTGCAGGGCTGGGCA
ATTGAGGTGCGTAATTCAA -> TTGAGGTGCGTAATTCAAG
CTAAGACGTTGGAAGCCAG -> TAAGACGTTGGAAGCCAGA
TATTCCCCTTACATAGTCA -> ATTCCCCTTACATAGTCAT
AGTCGATTCCCTACCTTCT -> GTCGATTCCCTACCTTCTG
CATTCCCCCCAACAATTCC -> ATTCCCCCCAACAATTCCA
AATCGTCTTTGCGTAGTAA -> ATCGTCTTTGCGTAGTAAA
GAGTTGCCGAACTAAATGA -> AGTTGCCGAACTAAATGAC
GCTTCGTATAGAGCAAGAT -> CTTCGTATAGAGCAAGATT
AATACTCTTGGCGAGGGTA -> ATACTCTTGGCGAGGGTAA
TGCGTTCAATTATCAGTCG -> GCGTTCAATTATCAGTCGA
CTGGGCGTGACATTGCTCA -> TGGGCGTGACATTGCTCAG
AAGTTATTACGTGGATATC -> AGTTATTACGTGGATATCA
ACTATGACGGGGTGAACCA -> CTATGACGGGGTGAACCAT
GAGGCGCGTTTTGTAACAC -> AGGCGCGTTTTGTAACACG
CGTTGCCGAAATCGTCTTT -> GTTGCCGAAATCGTCTTTG
AGCACCTGGAGCGCTTTAA -> GCACCTGGAGCGCTTTAAA
GCAAGCTGTCTTCAACGGG -> CAAGCTGTCTTCAACGGGC
CTACCTTCTGAACTATGGA -> TACCTTCTGAACTATGGAG
CTCAATGGAGGGGTTCCGC -> TCAATGGAGGGGTTCCGCC
ACCATAATTCATACCGCAA -> CCATAATTCATACCGCAAA
GACTAGCTACATTATGTAT -> ACTAGCTACATTATGTATA
AGAATCAGCCCTACGCCTA -> GAATCAGCCCTACGCCTAG
TGCCAGAGGACTGTCCAAG -> GCCAGAGGACTGTCCAAGT
ATTACCTCCGTACCATAAA -> TTACCTCCGTACCATAAAC
CCGCAAACGGTCCTGATCG -> CGCAAACGGTCCTGATCGT
GATAGAGGCACTGATGGCG -> ATAGAGGCACTGATGGCGT
GATTCATCCGGCAAAGAGG -> ATTCATCCGGCAAAGAGGC
TATCAATCCTCAGGTCCTT -> ATCAATCCTCAGGTCCTTC
TCCATTCCCCCCAACAATT -> CCATTCCCCCCAACAATTC
TAATCAGACGGCGACTAGC -> AATCAGACGGCGACTAGCT
ATCCTAACGAACAATTTTG -> TCCTAACGAACAATTTTGG
AATTTTCAAAAGTTATTAC -> ATTTTCAAAAGTTATTACG
TGCGAAGAGCATGATAGAG -> GCGAAGAGCATGATAGAGG
TACACTGCTGGAAACCTTA -> ACACTGCTGGAAACCTTAC
CACGGGGAGCATAAGTTTC -> ACGGGGAGCATAAGTTTCT
AGGCACTGATGGCGTACTG -> GGCACTGATGGCGTACTGC
CAACAATTCCAGGAGGCAG -> AACAATTCCAGGAGGCAGA
CTACAGAGAATTGCTCGAA -> TACAGAGAATTGCTCGAAC
AATCACAGCAGTATGGGCG -> ATCACAGCAGTATGGGCGC
CATCATTGAGGTGCGTAAT -> ATCATTGAGGTGCGTAATT
GTGCTGAGGGTTGTTCGCG -> TGCTGAGGGTTGTTCGCGA
AACTATGACGGGGTGAACC -> ACTATGACGGGGTGAACCA
CGTCAGCAGAATGCGAGTG -> GTCAGCAGAATGCGAGTGG
CAAACGTGAAGTTGCTGTA -> AAACGTGAAGTTGCTGTAA
TCATATCTGTCGGGAGTTC -> CATATCTGTCGGGAGTTCA
GAGCACCTGGAGCGCTTTA -> AGCACCTGGAGCGCTTTAA
AACCGTGGACCGCCGTGCG -> ACCGTGGACCGCCGTGCGC
ATTTGTAAGTGACGCCACT -> TTTGTAAGTGACGCCACTT
TCATCCGGCAAAGAGGCCG -> CATCCGGCAAAGAGGCCGC
ACTATGCGCTTCACCGTCA -> CTATGCGCTTCACCGTCAT
CGTCCGTGTGCCCTAGCTT -> GTCCGTGTGCCCTAGCTTA
TCTGAACTATGGAGCGGCT -> CTGAACTATGGAGCGGCTA
AGCAGCTGAATATCCCAGA -> GCAGCTGAATATCCCAGAG
GTGCCCACGATATCGCTTT -> TGCCCACGATATCGCTTTG
TAAAGGGCCTCACGGTACC -> AAAGGGCCTCACGGTACCG
AAATCAATTCATATCTGTC -> AATCAATTCATATCTGTCG
CCATCAGTATGGCATCGAG -> CATCAGTATGGCATCGAGC
TTATCAGTCGATTCCCTAC -> TATCAGTCGATTCCCTACC
GACACGATGCCTCCCGTGC -> ACACGATGCCTCCCGTGCC
CGAGTGGCTAGTTGCCTAC -> GAGTGGCTAGTTGCCTACC
CTGCGCATGCGTGTCTAAA -> TGCGCATGCGTGTCTAAAG
TTGCCAGAGGACTGTCCAA -> TGCCAGAGGACTGTCCAAG
ATTTTATCCTAACGAACAA -> TTTTATCCTAACGAACAAT
ATCACCTCAATACTTGTGC -> TCACCTCAATACTTGTGCA
CAATACTTGTGCAATACTC -> AATACTTGTGCAATACTCT
GCACAGCTGGCTCGCAACC -> CACAGCTGGCTCGCAACCG
TACTGGGCGTGACATTGCT -> ACTGGGCGTGACATTGCTC
GAGGAACCGTGACCATGGC -> AGGAACCGTGACCATGGCG
TTCCCTACCTTCTGAACTA -> TCCCTACCTTCTGAACTAT
GCGGTTCTTAGTACGACGC -> CGGTTCTTAGTACGACGCG
TACTCTAACTTGGGCACCG -> ACTCTAACTTGGGCACCGA
ATTCCAGGAGGCAGAGCCA -> TTCCAGGAGGCAGAGCCAT
TCCGTGCCTTGGAAATGAG -> CCGTGCCTTGGAAATGAGG
CAGGGCACCTTCCCGTCAA -> AGGGCACCTTCCCGTCAAG
GCGTTGCTTTAGCGCAGCT -> CGTTGCTTTAGCGCAGCTA
ATCAGTCGATTCCCTACCT -> TCAGTCGATTCCCTACCTT
ATCCCAGAGCTTCTTCTCG -> TCCCAGAGCTTCTTCTCGA
CCGAAATCGTCTTTGCGTA -> CGAAATCGTCTTTGCGTAG
TTTCTGACGGCGGAGGACT -> TTCTGACGGCGGAGGACTT
CCTGGCTGAGACCTGATTA -> CTGGCTGAGACCTGATTAG
GCACCGATGGTTCCTACCT -> CACCGATGGTTCCTACCTT
CTGTGCGGAGTCTAGACTG -> TGTGCGGAGTCTAGACTGG
GTAAATTTATGGCAAGGAC -> TAAATTTATGGCAAGGACC
GTCTCACTAGAATGCGAGT -> TCTCACTAGAATGCGAGTT
GACAGCTCTTATACACCGC -> ACAGCTCTTATACACCGCT
CTTCCCGTCAAGGAACGTT -> TTCCCGTCAAGGAACGTTC
AGAGCATGATAGAGGCACT -> GAGCATGATAGAGGCACTG
GATGGCGCGCCTATACTAC -> ATGGCGCGCCTATACTACA
GGGTAAATCAATTCATATC -> GGTAAATCAATTCATATCT
AATTCATACCGCAAACGTG -> ATTCATACCGCAAACGTGA
CACAGCTGGCTCGCAACCG -> ACAGCTGGCTCGCAACCGC
TGTACTAACGGAGGCATCC -> GTACTAACGGAGGCATCCA
CTACAGCGCTCCTACCCCA -> TACAGCGCTCCTACCCCAA
CGTTTTGTAACACGTCTGT -> GTTTTGTAACACGTCTGTG
GAACCATAATTCATACCGC -> AACCATAATTCATACCGCA
TAATGCTATTTTCGGATGG -> AATGCTATTTTCGGATGGA
CGTCTTTGCGTAGTAAATT -> GTCTTTGCGTAGTAAATTT
CCTGATCGTAACATGTGTA -> CTGATCGTAACATGTGTAG
GGCGGTCGGGTGAGCAAAC -> GCGGTCGGGTGAGCAAACG
TTCATGTTAGCTACATCTG -> TCATGTTAGCTACATCTGA
GTTCCAGTACCGTTTCCTT -> TTCCAGTACCGTTTCCTTC
GCAAAGATCCAATTGCCAG -> CAAAGATCCAATTGCCAGA
TGTCCACATTTAAAAACTT -> GTCCACATTTAAAAACTTC
GAAATCGTCTTTGCGTAGT -> AAATCGTCTTTGCGTAGTA
CGCGATTACTGGGCGTGAC -> GCGATTACTGGGCGTGACA
TGCCTTGGAAATGAGGAGG -> GCCTTGGAAATGAGGAGGC
ACATCCGTGCCTTGGAAAT -> CATCCGTGCCTTGGAAATG
AGTTCACCCCATCAGTATG -> GTTCACCCCATCAGTATGG
CTTTAAAACTACACTGCTG -> TTTAAAACTACACTGCTGG
ATTGCACAATAACATTCTT -> TTGCACAATAACATTCTTA
CGGCAAAGAGGCCGCTGAG -> GGCAAAGAGGCCGCTGAGC
GGAGGCAGAGCCATTCGAG -> GAGGCAGAGCCATTCGAGA
TTCCCCTTACATAGTCATG -> TCCCCTTACATAGTCATGT
AATGCTGCGCATGCGTGTC -> ATGCTGCGCATGCGTGTCT
TAACCCTCCTGTTCGGCAC -> AACCCTCCTGTTCGGCACA
CTCCTACCCCAATAATTTT -> TCCTACCCCAATAATTTTC
AACTATGGAGCGGCTATCC -> ACTATGGAGCGGCTATCCA
CGCTGAGCGTTGCTTTAGC -> GCTGAGCGTTGCTTTAGCG
CATAGTCATGTGACCCTCA -> ATAGTCATGTGACCCTCAC
ATCGTTGAATCACGGAATC -> TCGTTGAATCACGGAATCT
ACCCGATCGCCCGCGTGGG -> CCCGATCGCCCGCGTGGGG
CAAGGCAGACGCTTCGTAT -> AAGGCAGACGCTTCGTATA
CGGCTATCCATAATTCATA -> GGCTATCCATAATTCATAC
TCGGTATTTCTGACGGCGG -> CGGTATTTCTGACGGCGGA
TTACATAGTCATGTGACCC -> TACATAGTCATGTGACCCT
CCTGTTCGGCACAGCTGGC -> CTGTTCGGCACAGCTGGCT
GGCTGGGCAGATGTGAGTT -> GCTGGGCAGATGTGAGTTG
TGGGCGCAATATCTCCAGC -> GGGCGCAATATCTCCAGCA
CTTTTCTGTACTCTAACTT -> TTTTCTGTACTCTAACTTG
GCGTACTGCATCTATCCTC -> CGTACTGCATCTATCCTCA
CGGCACAGCTGGCTCGCAA -> GGCACAGCTGGCTCGCAAC
CCACATTTAAAAACTTCTG -> CACATTTAAAAACTTCTGA
CAGTACCGTTTCCTTCATG -> AGTACCGTTTCCTTCATGT
ATGAAACCGCGAGCGTCTC -> TGAAACCGCGAGCGTCTCA
GGAGCGCTTTAAAACTACA -> GAGCGCTTTAAAACTACAC
ATTGCCAGAGGACTGTCCA -> TTGCCAGAGGACTGTCCAA
TATGGCAAGGACCTGTGTT -> ATGGCAAGGACCTGTGTTA
CGCCCGTCTGTGCATTACG -> GCCCGTCTGTGCATTACGA
GAATGCTGCGCATGCGTGT -> AATGCTGCGCATGCGTGTC
ACCGCAAACGTGAAGTTGC -> CCGCAAACGTGAAGTTGCT
ACCTCCGTACCATAAACGT -> CCTCCGTACCATAAACGTG
CAGGTTAAGCTGCCGAGGC -> AGGTTAAGCTGCCGAGGCA
ACCTTCTGAACTATGCGCT -> CCTTCTGAACTATGCGCTT
TACCTTCTGAACTATGGAG -> ACCTTCTGAACTATGGAGC
AACACGTATTTAATCAGAC -> ACACGTATTTAATCAGACG
CTGAACTATGGAGCGGCTA -> TGAACTATGGAGCGGCTAT
CCGGCAAAGAGGCCGCTGA -> CGGCAAAGAGGCCGCTGAG
CGTATCAATCCTCAGGTCC -> GTATCAATCCTCAGGTCCT
CACGCTGGGGAATTAGTAA -> ACGCTGGGGAATTAGTAAC
GAGGAGGCGCGTTTTGTAA -> AGGAGGCGCGTTTTGTAAC
GTGCAATACTCTTGGCGAG -> TGCAATACTCTTGGCGAGG
GTACCGTTTCCTTCATGTT -> TACCGTTTCCTTCATGTTA
TATTTAATCAGACGGCGAC -> ATTTAATCAGACGGCGACT
CCCCTTACATAGTCATGTG -> CCCTTACATAGTCATGTGA
ATTACAATGCCTCAATGGA -> TTACAATGCCTCAATGGAG
AATTCCAGGAGGCAGAGCC -> ATTCCAGGAGGCAGAGCCA
ATCATTGAGGTGCGTAATT -> TCATTGAGGTGCGTAATTC
AACTATGCGCTTCACCGTC -> ACTATGCGCTTCACCGTCA
CGTGCCCACGATATCGCTT -> GTGCCCACGATATCGCTTT
GAATTGCACAATAACATTC -> AATTGCACAATAACATTCT
TTACGGATATTCCCCTTAC -> TACGGATATTCCCCTTACA
CCTCGGTATTTCTGACGGC -> CTCGGTATTTCTGACGGCG
CATACCGCAAACGGTCCTG -> ATACCGCAAACGGTCCTGA
TGAGCGTTGCTTTAGCGCA -> GAGCGTTGCTTTAGCGCAG
AGGGCCTCACGGTACCGAG -> GGGCCTCACGGTACCGAGG
GCCCGCGTGGGGTACGCTC -> CCCGCGTGGGGTACGCTCG
AGCCTGGCTGAGACCTGAT -> GCCTGGCTGAGACCTGATT
CTGAATATCCCAGAGCTTC -> TGAATATCCCAGAGCTTCT
GTCTAGACTGGTGTTTCAT -> TCTAGACTGGTGTTTCATG
TTTCATGTCGTCAGCAGAA -> TTCATGTCGTCAGCAGAAT
ACAGTGCTGAGGGTTGTTC -> CAGTGCTGAGGGTTGTTCG
GCAGATGTGAGTTGAGTGC -> CAGATGTGAGTTGAGTGCG
GCAGACGCTTCGTATAGAG -> CAGACGCTTCGTATAGAGC
ACGGGGAGCATAAGTTTCT -> CGGGGAGCATAAGTTTCTG
TCTGTCGGGAGTTCACCCC -> CTGTCGGGAGTTCACCCCA
GTGAAGTTGCTGTAATGCT -> TGAAGTTGCTGTAATGCTA
AGTTAAACAAGGCAGACGC -> GTTAAACAAGGCAGACGCT
GTCAAGGAACGTTCCAGTA -> TCAAGGAACGTTCCAGTAC
TCGATTCCCTACCTTCTGA -> CGATTCCCTACCTTCTGAA
TGAGTTGAGTGCGAACTGT -> GAGTTGAGTGCGAACTGTG
CAGCGCTCCTACCCCAATA -> AGCGCTCCTACCCCAATAA
CACATTTAAAAACTTCTGA -> ACATTTAAAAACTTCTGAA
TCCTACAGAGAATTGCTCG -> CCTACAGAGAATTGCTCGA
ACTTGTGCAATACTCTTGG -> CTTGTGCAATACTCTTGGC
CCCAGAGCTTCTTCTCGAT -> CCAGAGCTTCTTCTCGATG
CCTCGTGCGAAGAGCATGA -> CTCGTGCGAAGAGCATGAT
ACTCTAACTTGGGCACCGA -> CTCTAACTTGGGCACCGAT
TACATCTGAGTTGCGAATG -> ACATCTGAGTTGCGAATGG
CTTCTGAACTATGTCGCGT -> TTCTGAACTATGTCGCGTC
GTCTTTGCGTAGTAAATTT -> TCTTTGCGTAGTAAATTTA
GATGGTTCCTACCTTCTGA -> ATGGTTCCTACCTTCTGAA
TCTCGATGGAATCGCTGTA -> CTCGATGGAATCGCTGTAA
GAGGTCACAGTGCTGAGGG -> AGGTCACAGTGCTGAGGGT
TTTGTAACACGTCTGTGCG -> TTGTAACACGTCTGTGCGG
TAACGCGCCTCGTCATCCT -> AACGCGCCTCGTCATCCTA
TCATCCTACAGAGAATTGC -> CATCCTACAGAGAATTGCT
TCCAATTGCCAGAGGACTG -> CCAATTGCCAGAGGACTGT
CTTAATTGTTATTTGTAAG -> TTAATTGTTATTTGTAAGT
TCATGTTAGCTACATCTGA -> CATGTTAGCTACATCTGAG
CGCAAACGTGAAGTTGCTG -> GCAAACGTGAAGTTGCTGT
CTAACGGAGGCATCCATTC -> TAACGGAGGCATCCATTCC
TAACTTGGGCACCGATGGT -> AACTTGGGCACCGATGGTT
CCTCAATACTTGTGCAATA -> CTCAATACTTGTGCAATAC
CAATGCCTCAATGGAGGGG -> AATGCCTCAATGGAGGGGT
AGTAAATTTATGGCAAGGA -> GTAAATTTATGGCAAGGAC
AACCTACCTTCTGAACTAT -> ACCTACCTTCTGAACTATG
TCACCGTCATAATTCATAC -> CACCGTCATAATTCATACC
GTGACGCCACTTTTCTGTA -> TGACGCCACTTTTCTGTAC
GCTAGATAGTGCAGGGCTG -> CTAGATAGTGCAGGGCTGG
TAAATTTATGGCAAGGACC -> AAATTTATGGCAAGGACCT
CGTGTCTAAAGGGCCTCAC -> GTGTCTAAAGGGCCTCACG
TAGAGGTCACAGTGCTGAG -> AGAGGTCACAGTGCTGAGG
CCTCAGAGCCAGAGCCTGG -> CTCAGAGCCAGAGCCTGGC
ACAATGCCTCAATGGAGGG -> CAATGCCTCAATGGAGGGG
GGAATCGCTGTAATTTTAT -> GAATCGCTGTAATTTTATC
AGACAGCTCTTATACACCG -> GACAGCTCTTATACACCGC
CGTTCCAGTACCGTTTCCT -> GTTCCAGTACCGTTTCCTT
CAAGTTGGTTGAGGAACCG -> AAGTTGGTTGAGGAACCGT
TCCGTACCATAAACGTGCG -> CCGTACCATAAACGTGCGG
GAACTATCGTGCAAAGATC -> AACTATCGTGCAAAGATCC
CGATGGAATCGCTGTAATT -> GATGGAATCGCTGTAATTT
TGCCGAAATCGTCTTTGCG -> GCCGAAATCGTCTTTGCGT
AGGGGTTCCGCCCGTCTGT -> GGGGTTCCGCCCGTCTGTG
GGCACCGATGGTTCCTACC -> GCACCGATGGTTCCTACCT
GGTTCCTACCTTCTGAACT -> GTTCCTACCTTCTGAACTA
GCGTAATTCAAGATCTAAC -> CGTAATTCAAGATCTAACC
CCAGCATGAATCCTCGTGC -> CAGCATGAATCCTCGTGCG
ACGTTATTAGTACGTCCGT -> CGTTATTAGTACGTCCGTG
TTCATCCGGCAAAGAGGCC -> TCATCCGGCAAAGAGGCCG
GCAGAGGCGGTCGGGTGAG -> CAGAGGCGGTCGGGTGAGC
TTTAAAAACTTCTGAATGC -> TTAAAAACTTCTGAATGCT
GAACGAGTGACGTTTGATT -> AACGAGTGACGTTTGATTA
CCCTGCATAATTCATACCG -> CCTGCATAATTCATACCGC
GCCGTGCGCCTCGGTATTT -> CCGTGCGCCTCGGTATTTC
ATATTCCCCTTACATAGTC -> TATTCCCCTTACATAGTCA
CGGTACCGAGGTAGGATTC -> GGTACCGAGGTAGGATTCG
GGACAATATACATCAGCTG -> GACAATATACATCAGCTGT
GGGCACCGATGGTTCCTAC -> GGCACCGATGGTTCCTACC
CCAGAGCTTCTTCTCGATG -> CAGAGCTTCTTCTCGATGG
TCTAGACTGGTGTTTCATG -> CTAGACTGGTGTTTCATGT
AGAGGCGGTCGGGTGAGCA -> GAGGCGGTCGGGTGAGCAA
GAAACCTTACGGATATTCC -> AAACCTTACGGATATTCCC
GCCACTTTTCTGTACTCTA -> CCACTTTTCTGTACTCTAA
TGACCCTCACCAGCACGCT -> GACCCTCACCAGCACGCTG
AGTACCGTTTCCTTCATGT -> GTACCGTTTCCTTCATGTT
CACGTATTTAATCAGACGG -> ACGTATTTAATCAGACGGC
CGAGGTAGGATTCGTCTAT -> GAGGTAGGATTCGTCTATG
TTAGTAACGCGCCTCGTCA -> TAGTAACGCGCCTCGTCAT
AGCAGAATGCGAGTGGCTA -> GCAGAATGCGAGTGGCTAG
ATACCCGATCGCCCGCGTG -> TACCCGATCGCCCGCGTGG
CCGTCTGTGCATTACGATG -> CGTCTGTGCATTACGATGA
CCATAACCCTCCTGTTCGG -> CATAACCCTCCTGTTCGGC
TGTAACACGTCTGTGCGGA -> GTAACACGTCTGTGCGGAG
TCCAGGAGGCAGAGCCATT -> CCAGGAGGCAGAGCCATTC
CCCGTCAAGGAACGTTCCA -> CCGTCAAGGAACGTTCCAG
CTGAGACCTGATTAGGGAT -> TGAGACCTGATTAGGGATT
TCCCCTTACATAGTCATGT -> CCCCTTACATAGTCATGTG
CGAACTAAATGACGGTTTG -> GAACTAAATGACGGTTTGT
GACGTTATTAGTACGTCCG -> ACGTTATTAGTACGTCCGT
TTCTGAACTATGGAGCGGC -> TCTGAACTATGGAGCGGCT
TTAAAACTACACTGCTGGA -> TAAAACTACACTGCTGGAA
TGCAATACTCTTGGCGAGG -> GCAATACTCTTGGCGAGGG
GCCCTAGCTTATAGCATGT -> CCCTAGCTTATAGCATGTC
GAATCAGCCCTACGCCTAG -> AATCAGCCCTACGCCTAGC
CTTCACCGTCATAATTCAT -> TTCACCGTCATAATTCATA
TAACATTCTTATACCCGAT -> AACATTCTTATACCCGATC
TCAACGGGCACGGGGAGCA -> CAACGGGCACGGGGAGCAT
ATCGCTTTGTTGATAATCG -> TCGCTTTGTTGATAATCGT
ATTCCCTACCTTCTGAACT -> TTCCCTACCTTCTGAACTA
GAGGGGTTCCGCCCGTCTG -> AGGGGTTCCGCCCGTCTGT
CCTACCTTCTGAACTATGG -> CTACCTTCTGAACTATGGA
CGGGCACGGGGAGCATAAG -> GGGCACGGGGAGCATAAGT
GGACCTGTGTTACCGTCCG -> GACCTGTGTTACCGTCCGC
TTAGCGCAGCTAACCTACC -> TAGCGCAGCTAACCTACCT
TTAGCTACATCTGAGTTGC -> TAGCTACATCTGAGTTGCG
TCCATAATTCATACCGCAA -> CCATAATTCATACCGCAAA
GGATTCGTCTATGAGAATT -> GATTCGTCTATGAGAATTG
TCTGCGTTCAATTATCAGT -> CTGCGTTCAATTATCAGTC
CCTCGTCATCCTACAGAGA -> CTCGTCATCCTACAGAGAA
AATAATTTTCAAAAGTTAT -> ATAATTTTCAAAAGTTATT
AATCAGCCCTACGCCTAGC -> ATCAGCCCTACGCCTAGCA
CGTATTTAATCAGACGGCG -> GTATTTAATCAGACGGCGA
AGGAACGTTCCAGTACCGT -> GGAACGTTCCAGTACCGTT
GCCTAGCAGCTGAATATCC -> CCTAGCAGCTGAATATCCC
CAAACTTGTCCACATTTAA -> AAACTTGTCCACATTTAAA
AGGAACCGTGACCATGGCG -> GGAACCGTGACCATGGCGT
CTGTAATTTTATCCTAACG -> TGTAATTTTATCCTAACGA
GCAGAGCCATTCGAGAAGT -> CAGAGCCATTCGAGAAGTT
AGTCAGGTTAAGCTGCCGA -> GTCAGGTTAAGCTGCCGAG
TAGGATTCGTCTATGAGAA -> AGGATTCGTCTATGAGAAT
CCGCACATCGAGAGTCTAT -> CGCACATCGAGAGTCTATC
GCTGTGCCATAACCCTCCT -> CTGTGCCATAACCCTCCTG
CGGATGGATACATCCGTGC -> GGATGGATACATCCGTGCC
GCTGAGACCTGATTAGGGA -> CTGAGACCTGATTAGGGAT
GATGGCGTACTGCATCTAT -> ATGGCGTACTGCATCTATC
TTCATACCGCAAACTTGTC -> TCATACCGCAAACTTGTCC
GAGAAGTTCCCTCAGAGCC -> AGAAGTTCCCTCAGAGCCA
AATGGCGCTTATAGAGGTC -> ATGGCGCTTATAGAGGTCA
TGAAGTTGCTGTAATGCTA -> GAAGTTGCTGTAATGCTAT
CCCAATAATTTTCAAAAGT -> CCAATAATTTTCAAAAGTT
AAAACTTCTGAATGCTGCG -> AAACTTCTGAATGCTGCGC
GATCCCTTAGAAGTTAAAC -> ATCCCTTAGAAGTTAAACA
GCGTTTTGTAACACGTCTG -> CGTTTTGTAACACGTCTGT
CAAAAGTTATTACGTGGAT -> AAAAGTTATTACGTGGATA
GAGCATGATAGAGGCACTG -> AGCATGATAGAGGCACTGA
AATTCATACCGCAAACACG -> ATTCATACCGCAAACACGT
TTGCTCGAACGAGTGACGT -> TGCTCGAACGAGTGACGTT
GTAATCACAGCAGTATGGG -> TAATCACAGCAGTATGGGC
TATCCATAATTCATACCGC -> ATCCATAATTCATACCGCA
ATTAGTCCGTTGCCGAAAT -> TTAGTCCGTTGCCGAAATC
AGACGTTGGAAGCCAGACA -> GACGTTGGAAGCCAGACAG
CTATGACGGGGTGAACCAT -> TATGACGGGGTGAACCATA
GGACTGTCCAAGTTGGTTG -> GACTGTCCAAGTTGGTTGA
AACATTCTTATACCCGATC -> ACATTCTTATACCCGATCG
GCAGATTCATCCGGCAAAG -> CAGATTCATCCGGCAAAGA
GGGTGAACCATAATTCATA -> GGTGAACCATAATTCATAC
CAAGATCTAACCCGCACAT -> AAGATCTAACCCGCACATC
GTGGACCGCCGTGCGCCTC -> TGGACCGCCGTGCGCCTCG
TGGGCAGATGTGAGTTGAG -> GGGCAGATGTGAGTTGAGT
CATACCGCAAACTTGTCCA -> ATACCGCAAACTTGTCCAC
CCTTGGAAATGAGGAGGCG -> CTTGGAAATGAGGAGGCGC
TGAGGAACCGTGACCATGG -> GAGGAACCGTGACCATGGC
AATGCCTCAATGGAGGGGT -> ATGCCTCAATGGAGGGGTT
AGATCTAACCCGCACATCG -> GATCTAACCCGCACATCGA
GTGACCATGGCGTACTCGT -> TGACCATGGCGTACTCGTG
TTTTGTAACACGTCTGTGC -> TTTGTAACACGTCTGTGCG
GCACCTGGAGCGCTTTAAA -> CACCTGGAGCGCTTTAAAA
CCTCAATGGAGGGGTTCCG -> CTCAATGGAGGGGTTCCGC
CAGAGCCATTCGAGAAGTT -> AGAGCCATTCGAGAAGTTC
CATTATGTATATTAGTCCG -> ATTATGTATATTAGTCCGT
TATGACGGGGTGAACCATA -> ATGACGGGGTGAACCATAA
GCGAGCGTCTCACTAGAAT -> CGAGCGTCTCACTAGAATG
CACCAGCACGCTGGGGAAT -> ACCAGCACGCTGGGGAATT
TCATACCGCAAACACGTAT -> CATACCGCAAACACGTATT
ATGCGCTTCACCGTCATAA -> TGCGCTTCACCGTCATAAT
CGCTTCGTATAGAGCAAGA -> GCTTCGTATAGAGCAAGAT
AGCGGCTATCCATAATTCA -> GCGGCTATCCATAATTCAT
TGGCTGAGACCTGATTAGG -> GGCTGAGACCTGATTAGGG
TGCGTAATTCAAGATCTAA -> GCGTAATTCAAGATCTAAC
TACTACAGCGCTCCTACCC -> ACTACAGCGCTCCTACCCC
TGCCCTAGCTTATAGCATG -> GCCCTAGCTTATAGCATGT
CATGTGACCCTCACCAGCA -> ATGTGACCCTCACCAGCAC
AGCTCTTATACACCGCTAG -> GCTCTTATACACCGCTAGA
GGCACCTTCCCGTCAAGGA -> GCACCTTCCCGTCAAGGAA
TAATTCATACCGCAAACAC -> AATTCATACCGCAAACACG
GTTTGTACTAACGGAGGCA -> TTTGTACTAACGGAGGCAT
GGCAGATGTGAGTTGAGTG -> GCAGATGTGAGTTGAGTGC
CGTTTGATTACCTCCGTAC -> GTTTGATTACCTCCGTACC
TGGGCGTGACATTGCTCAG -> GGGCGTGACATTGCTCAGG
AGCGCAGCTAACCTACCTT -> GCGCAGCTAACCTACCTTC
GAGGGTAAATCAATTCATA -> AGGGTAAATCAATTCATAT
GCTGTAATGCTATTTTCGG -> CTGTAATGCTATTTTCGGA
CTCACGGTACCGAGGTAGG -> TCACGGTACCGAGGTAGGA
AGGCGCGTTTTGTAACACG -> GGCGCGTTTTGTAACACGT
TGTTCGGCACAGCTGGCTC -> GTTCGGCACAGCTGGCTCG
AGACACGATGCCTCCCGTG -> GACACGATGCCTCCCGTGC
TCACTAGAATGCGAGTTGC -> CACTAGAATGCGAGTTGCC
ATAAACGTGCGGTTCTTAG -> TAAACGTGCGGTTCTTAGT
TCACCTAAGACGTTGGAAG -> CACCTAAGACGTTGGAAGC
GCATGCGTGTCTAAAGGGC -> CATGCGTGTCTAAAGGGCC
ATGATAGAGGCACTGATGG -> TGATAGAGGCACTGATGGC
TGGAGCGCTTTAAAACTAC -> GGAGCGCTTTAAAACTACA
TCCGTTGCCGAAATCGTCT -> CCGTTGCCGAAATCGTCTT
GAACTAAATGACGGTTTGT -> AACTAAATGACGGTTTGTA
CAAACGGTCCTGATCGTAA -> AAACGGTCCTGATCGTAAC
CTGTAATGCTATTTTCGGA -> TGTAATGCTATTTTCGGAT
ATCGTGCAAAGATCCAATT -> TCGTGCAAAGATCCAATTG
TTTCAAAAGTTATTACGTG -> TTCAAAAGTTATTACGTGG
CGCAAACGGTCCTGATCGT -> GCAAACGGTCCTGATCGTA
TCGAGCACCTGGAGCGCTT -> CGAGCACCTGGAGCGCTTT
AAACCTTACGGATATTCCC -> AACCTTACGGATATTCCCC
TTATGGCAAGGACCTGTGT -> TATGGCAAGGACCTGTGTT
CGGATATTCCCCTTACATA -> GGATATTCCCCTTACATAG
GCCTCGTCATCCTACAGAG -> CCTCGTCATCCTACAGAGA
GGGGTGAACCATAATTCAT -> GGGTGAACCATAATTCATA
CCTACGCCTAGCAGCTGAA -> CTACGCCTAGCAGCTGAAT
TTGTACTAACGGAGGCATC -> TGTACTAACGGAGGCATCC
CGAAAAGAGGATGGCGCGC -> GAAAAGAGGATGGCGCGCC
AGAGCCATTCGAGAAGTTC -> GAGCCATTCGAGAAGTTCC
TCATACCGCAAACGGTCCT -> CATACCGCAAACGGTCCTG
TAGACACGATGCCTCCCGT -> AGACACGATGCCTCCCGTG
ATCAGCCCTACGCCTAGCA -> TCAGCCCTACGCCTAGCAG
ACCGCAAACACGTATTTAA -> CCGCAAACACGTATTTAAT
GCTCGCAACCGCACCTAGT -> CTCGCAACCGCACCTAGTT
CCCGCAGATTCATCCGGCA -> CCGCAGATTCATCCGGCAA
TGTAATTTTATCCTAACGA -> GTAATTTTATCCTAACGAA
GGTATTTCTGACGGCGGAG -> GTATTTCTGACGGCGGAGG
TGACGCGATTACTGGGCGT -> GACGCGATTACTGGGCGTG
AAATGACGGTTTGTACTAA -> AATGACGGTTTGTACTAAC
ATGAGGAGGCGCGTTTTGT -> TGAGGAGGCGCGTTTTGTA
GGGCACCTTCCCGTCAAGG -> GGCACCTTCCCGTCAAGGA
TTCTTATACCCGATCGCCC -> TCTTATACCCGATCGCCCG
TACAGCGCTCCTACCCCAA -> ACAGCGCTCCTACCCCAAT
CGGGAGTTCACCCCATCAG -> GGGAGTTCACCCCATCAGT
TCCAGCATGAATCCTCGTG -> CCAGCATGAATCCTCGTGC
CGAGTGACGTTTGATTACC -> GAGTGACGTTTGATTACCT
GCCTGGCTGAGACCTGATT -> CCTGGCTGAGACCTGATTA
GGCATCGAGCACCTGGAGC -> GCATCGAGCACCTGGAGCG
ATATACATCAGCTGTGCCA -> TATACATCAGCTGTGCCAT
TGTGCAATACTCTTGGCGA -> GTGCAATACTCTTGGCGAG
GAAGTTAAACAAGGCAGAC -> AAGTTAAACAAGGCAGACG
GAATTAGTAACGCGCCTCG -> AATTAGTAACGCGCCTCGT
AGGCATCCATTCCCCCCAA -> GGCATCCATTCCCCCCAAC
TAATTCATACCGCAAACTT -> AATTCATACCGCAAACTTG
AACGAGTGACGTTTGATTA -> ACGAGTGACGTTTGATTAC
GCGCATGCGTGTCTAAAGG -> CGCATGCGTGTCTAAAGGG
CGTCTATGAGAATTGCACA -> GTCTATGAGAATTGCACAA
CATACCGCAAACACGTATT -> ATACCGCAAACACGTATTT
CGCAAACACGTATTTAATC -> GCAAACACGTATTTAATCA
CGGCGTGCTCCAACCGTGG -> GGCGTGCTCCAACCGTGGA
AGAGGCACTGATGGCGTAC -> GAGGCACTGATGGCGTACT
TTATTTGTAAGTGACGCCA -> TATTTGTAAGTGACGCCAC
ATACTACAGCGCTCCTACC -> TACTACAGCGCTCCTACCC
AATATCCCAGAGCTTCTTC -> ATATCCCAGAGCTTCTTCT
CCCTTACATAGTCATGTGA -> CCTTACATAGTCATGTGAC
TGAACTATGACGGGGTGAA -> GAACTATGACGGGGTGAAC
GTTCGCGAAAAGAGGATGG -> TTCGCGAAAAGAGGATGGC
CGTGAAGTTGCTGTAATGC -> GTGAAGTTGCTGTAATGCT
TATCGCTTTGTTGATAATC -> ATCGCTTTGTTGATAATCG
CCTTACATAGTCATGTGAC -> CTTACATAGTCATGTGACC
GAGGCACTGATGGCGTACT -> AGGCACTGATGGCGTACTG
TCTAAAGGGCCTCACGGTA -> CTAAAGGGCCTCACGGTAC
AAGATTATGACGCGATTAC -> AGATTATGACGCGATTACT
TGCGTAGTAAATTTATGGC -> GCGTAGTAAATTTATGGCA
GGCACAGCTGGCTCGCAAC -> GCACAGCTGGCTCGCAACC
ACCGCAAACTTGTCCACAT -> CCGCAAACTTGTCCACATT
TCCCTCAGAGCCAGAGCCT -> CCCTCAGAGCCAGAGCCTG
CATGGCGTACTCGTGCAAG -> ATGGCGTACTCGTGCAAGC
CTCACTAGAATGCGAGTTG -> TCACTAGAATGCGAGTTGC
AGGTGCGTAATTCAAGATC -> GGTGCGTAATTCAAGATCT
GGAACGTTCCAGTACCGTT -> GAACGTTCCAGTACCGTTT
AGTTGAGTGCGAACTGTGG -> GTTGAGTGCGAACTGTGGG
TCCTACCTTCTGAACTATG -> CCTACCTTCTGAACTATGT
ATGTGTAGACACGATGCCT -> TGTGTAGACACGATGCCTC
GTTGGTTGAGGAACCGTGA -> TTGGTTGAGGAACCGTGAC
GTGCAAAGATCCAATTGCC -> TGCAAAGATCCAATTGCCA
ATGTTAGCTACATCTGAGT -> TGTTAGCTACATCTGAGTT
TATATTAGTCCGTTGCCGA -> ATATTAGTCCGTTGCCGAA
CAATACTCTTGGCGAGGGT -> AATACTCTTGGCGAGGGTA
TATGGGCGCAATATCTCCA -> ATGGGCGCAATATCTCCAG
GAGTGACGTTTGATTACCT -> AGTGACGTTTGATTACCTC
GAGGTAGGATTCGTCTATG -> AGGTAGGATTCGTCTATGA
TTATTACAATGCCTCAATG -> TATTACAATGCCTCAATGG
ATTCATACCGCAAACACGT -> TTCATACCGCAAACACGTA
TAACATGTGTAGACACGAT -> AACATGTGTAGACACGATG
TGTTGATAATCGTTGAATC -> GTTGATAATCGTTGAATCA
TGCGGTTCTTAGTACGACG -> GCGGTTCTTAGTACGACGC
ATCGTCTTTGCGTAGTAAA -> TCGTCTTTGCGTAGTAAAT
GTTTGATTACCTCCGTACC -> TTTGATTACCTCCGTACCA
CTCCAGCATGAATCCTCGT -> TCCAGCATGAATCCTCGTG
GTTATTAGTACGTCCGTGT -> TTATTAGTACGTCCGTGTG
TCGTCTATGAGAATTGCAC -> CGTCTATGAGAATTGCACA
GGGCGCAATATCTCCAGCA -> GGCGCAATATCTCCAGCAT
ATAGAGGCACTGATGGCGT -> TAGAGGCACTGATGGCGTA
GCGCTTATAGAGGTCACAG -> CGCTTATAGAGGTCACAGT
GTATAGAGCAAGATTATGA -> TATAGAGCAAGATTATGAC
TGCTGTAATGCTATTTTCG -> GCTGTAATGCTATTTTCGG
CTGAACTATGTCGCGTCCC -> TGAACTATGTCGCGTCCCT
CTGTGCATTACGATGAAAC -> TGTGCATTACGATGAAACC
ACATCGAGAGTCTATCACC -> CATCGAGAGTCTATCACCT
GGCCGGTAATCACAGCAGT -> GCCGGTAATCACAGCAGTA
TGCGAGTGGCTAGTTGCCT -> GCGAGTGGCTAGTTGCCTA
TTACCTCCGTACCATAAAC -> TACCTCCGTACCATAAACG
TTATACACCGCTAGATAGT -> TATACACCGCTAGATAGTG
TAGACGTTATTAGTACGTC -> AGACGTTATTAGTACGTCC
TTCAAAAGTTATTACGTGG -> TCAAAAGTTATTACGTGGA
TCGTATAGAGCAAGATTAT -> CGTATAGAGCAAGATTATG
CGATGCCTCCCGTGCCCAC -> GATGCCTCCCGTGCCCACG
AGACGTTATTAGTACGTCC -> GACGTTATTAGTACGTCCG
ACAATTCCAGGAGGCAGAG -> CAATTCCAGGAGGCAGAGC
CGCTTTAAAACTACACTGC -> GCTTTAAAACTACACTGCT
TATTTTCGGATGGATACAT -> ATTTTCGGATGGATACATC
CGATCCCTTAGAAGTTAAA -> GATCCCTTAGAAGTTAAAC
TCAGCTGTGCCATAACCCT -> CAGCTGTGCCATAACCCTC
CATCAGCTGTGCCATAACC -> ATCAGCTGTGCCATAACCC
TACGGATATTCCCCTTACA -> ACGGATATTCCCCTTACAT
ATGTCGTCATCATTGAGGT -> TGTCGTCATCATTGAGGTG
CCAGCACGCTGGGGAATTA -> CAGCACGCTGGGGAATTAG
ACCGGTAATAGACGTTATT -> CCGGTAATAGACGTTATTA
CGCAAACTTGTCCACATTT -> GCAAACTTGTCCACATTTA
GCTTTGTTGATAATCGTTG -> CTTTGTTGATAATCGTTGA
CGCGTTTTGTAACACGTCT -> GCGTTTTGTAACACGTCTG
ACGGAATCTTAATTGTTAT -> CGGAATCTTAATTGTTATT
ATAGACGTTATTAGTACGT -> TAGACGTTATTAGTACGTC
TCCCAGAGCTTCTTCTCGA -> CCCAGAGCTTCTTCTCGAT
GTTCACCCCATCAGTATGG -> TTCACCCCATCAGTATGGC
TCAGAGCCAGAGCCTGGCT -> CAGAGCCAGAGCCTGGCTG
CTAAAGGGCCTCACGGTAC -> TAAAGGGCCTCACGGTACC
AATATACATCAGCTGTGCC -> ATATACATCAGCTGTGCCA
TTCATGTCGTCAGCAGAAT -> TCATGTCGTCAGCAGAATG
CATAAGTTTCTGCGTTCAA -> ATAAGTTTCTGCGTTCAAT
GTTGCTGTAATGCTATTTT -> TTGCTGTAATGCTATTTTC
GGTCCTGATCGTAACATGT -> GTCCTGATCGTAACATGTG
ACAATATACATCAGCTGTG -> CAATATACATCAGCTGTGC
CCGTCAAGGAACGTTCCAG -> CGTCAAGGAACGTTCCAGT
TATCCTCAGAGAAAACCGG -> ATCCTCAGAGAAAACCGGT
CGTGACCATGGCGTACTCG -> GTGACCATGGCGTACTCGT
TCAATACTTGTGCAATACT -> CAATACTTGTGCAATACTC
CTAGTTTGCCTGAACTATC -> TAGTTTGCCTGAACTATCG
GTGTTACCGTCCGCGATCC -> TGTTACCGTCCGCGATCCC
TGATAGAGGCACTGATGGC -> GATAGAGGCACTGATGGCG
CAGGAGGCAGAGCCATTCG -> AGGAGGCAGAGCCATTCGA
GTAGTAAATTTATGGCAAG -> TAGTAAATTTATGGCAAGG
CTGAACTATGACGGGGTGA -> TGAACTATGACGGGGTGAA
TCCTCAGAGAAAACCGGTA -> CCTCAGAGAAAACCGGTAA
AATGCGAGTTGCCGAACTA -> ATGCGAGTTGCCGAACTAA
CGTCATCATTGAGGTGCGT -> GTCATCATTGAGGTGCGTA
AGCTACATCTGAGTTGCGA -> GCTACATCTGAGTTGCGAA
GCTGAGCGTTGCTTTAGCG -> CTGAGCGTTGCTTTAGCGC
ATCTATCCTCAGAGAAAAC -> TCTATCCTCAGAGAAAACC
CTATCACCTAAGACGTTGG -> TATCACCTAAGACGTTGGA
GCAATACTCTTGGCGAGGG -> CAATACTCTTGGCGAGGGT
TCGATGGAATCGCTGTAAT -> CGATGGAATCGCTGTAATT
CGTTCAATTATCAGTCGAT -> GTTCAATTATCAGTCGATT
AAGATCTAACCCGCACATC -> AGATCTAACCCGCACATCG
GGGTACGCTCGGTCCCGCA -> GGTACGCTCGGTCCCGCAG
GTAATGCTATTTTCGGATG -> TAATGCTATTTTCGGATGG
TTCAAGATCTAACCCGCAC -> TCAAGATCTAACCCGCACA
GTTTCATGTCGTCAGCAGA -> TTTCATGTCGTCAGCAGAA
GAATCGCTGTAATTTTATC -> AATCGCTGTAATTTTATCC
TACCGCAAACTTGTCCACA -> ACCGCAAACTTGTCCACAT
GGCATCCATTCCCCCCAAC -> GCATCCATTCCCCCCAACA
ACCTAAGACGTTGGAAGCC -> CCTAAGACGTTGGAAGCCA
GTCTATGAGAATTGCACAA -> TCTATGAGAATTGCACAAT
TTCTGAACTATGTCGCGTC -> TCTGAACTATGTCGCGTCC
CATACCGCAAACGTGAAGT -> ATACCGCAAACGTGAAGTT
GGTACCGAGGTAGGATTCG -> GTACCGAGGTAGGATTCGT
CGAGGCAGAGGCGGTCGGG -> GAGGCAGAGGCGGTCGGGT
CTTCTTCTCGATGGAATCG -> TTCTTCTCGATGGAATCGC
ATCCGTGCCTTGGAAATGA -> TCCGTGCCTTGGAAATGAG
CACCCCATCAGTATGGCAT -> ACCCCATCAGTATGGCATC
CAGGTCCTTCTGCTGCAGT -> AGGTCCTTCTGCTGCAGTC
TAATTTTCAAAAGTTATTA -> AATTTTCAAAAGTTATTAC
ACCTAGTTTGCCTGAACTA -> CCTAGTTTGCCTGAACTAT
TCGTCATCCTACAGAGAAT -> CGTCATCCTACAGAGAATT
ACTAAATGACGGTTTGTAC -> CTAAATGACGGTTTGTACT
CTCAATACTTGTGCAATAC -> TCAATACTTGTGCAATACT
TATTTGTAAGTGACGCCAC -> ATTTGTAAGTGACGCCACT
AGCAAGATTATGACGCGAT -> GCAAGATTATGACGCGATT
TCCCCCCAACAATTCCAGG -> CCCCCCAACAATTCCAGGA
TTCTGACGGCGGAGGACTT -> TCTGACGGCGGAGGACTTA
CTCAGGTCCTTCTGCTGCA -> TCAGGTCCTTCTGCTGCAG
TAATAGACGTTATTAGTAC -> AATAGACGTTATTAGTACG
TCTTCAACGGGCACGGGGA -> CTTCAACGGGCACGGGGAG
AATACTTGTGCAATACTCT -> ATACTTGTGCAATACTCTT
GTAACATGTGTAGACACGA -> TAACATGTGTAGACACGAT
ATCAGCTGTGCCATAACCC -> TCAGCTGTGCCATAACCCT
CTACATCTGAGTTGCGAAT -> TACATCTGAGTTGCGAATG
CTGTGTTACCGTCCGCGAT -> TGTGTTACCGTCCGCGATC
CCTGCATAATTCATACCGC -> CTGCATAATTCATACCGCA
AATCAGACGGCGACTAGCT -> ATCAGACGGCGACTAGCTA
GCATCGAGCACCTGGAGCG -> CATCGAGCACCTGGAGCGC
TTGCCGAAATCGTCTTTGC -> TGCCGAAATCGTCTTTGCG
CCCGCACATCGAGAGTCTA -> CCGCACATCGAGAGTCTAT
TGACGCCACTTTTCTGTAC -> GACGCCACTTTTCTGTACT
CATCTATCCTCAGAGAAAA -> ATCTATCCTCAGAGAAAAC
TTGCACAATAACATTCTTA -> TGCACAATAACATTCTTAT
TGTCGTCAGCAGAATGCGA -> GTCGTCAGCAGAATGCGAG
ATTACGATGAAACCGCGAG -> TTACGATGAAACCGCGAGC
AAACAAGGCAGACGCTTCG -> AACAAGGCAGACGCTTCGT
GCTTTAGCGCAGCTAACCT -> CTTTAGCGCAGCTAACCTA
TCATACCGCAAACGTGAAG -> CATACCGCAAACGTGAAGT
TTCTGCTGCAGTCAGGTTA -> TCTGCTGCAGTCAGGTTAA
GAGGACTGTCCAAGTTGGT -> AGGACTGTCCAAGTTGGTT
ATAGAGGTCACAGTGCTGA -> TAGAGGTCACAGTGCTGAG
AGTACGTCCGTGTGCCCTA -> GTACGTCCGTGTGCCCTAG
CTGTGGGACAATATACATC -> TGTGGGACAATATACATCA
ATACCGCAAACGGTCCTGA -> TACCGCAAACGGTCCTGAT
TCGTCAGCAGAATGCGAGT -> CGTCAGCAGAATGCGAGTG
TCAAGGAACGTTCCAGTAC -> CAAGGAACGTTCCAGTACC
TCCCGTCAAGGAACGTTCC -> CCCGTCAAGGAACGTTCCA
AGGATGGCGCGCCTATACT -> GGATGGCGCGCCTATACTA
AAGTTTCTGCGTTCAATTA -> AGTTTCTGCGTTCAATTAT
CGGAATCTTAATTGTTATT -> GGAATCTTAATTGTTATTT
AGGGTTGTTCGCGAAAAGA -> GGGTTGTTCGCGAAAAGAG
TTTATCCTAACGAACAATT -> TTATCCTAACGAACAATTT
GCGGTCGGGTGAGCAAACG -> CGGTCGGGTGAGCAAACGG
GTCTGTGCGGAGTCTAGAC -> TCTGTGCGGAGTCTAGACT
TATGGCATCGAGCACCTGG -> ATGGCATCGAGCACCTGGA
ACGTTTGATTACCTCCGTA -> CGTTTGATTACCTCCGTAC
GCTAGTTGCCTACCTTCTG -> CTAGTTGCCTACCTTCTGA
AGTTGCCTACCTTCTGAAC -> GTTGCCTACCTTCTGAACT
TGATAATCGTTGAATCACG -> GATAATCGTTGAATCACGG
TCACGGTACCGAGGTAGGA -> CACGGTACCGAGGTAGGAT
CTATGAGAATTGCACAATA -> TATGAGAATTGCACAATAA
GCATTACGATGAAACCGCG -> CATTACGATGAAACCGCGA
ACTATGGAGCGGCTATCCA -> CTATGGAGCGGCTATCCAT
ATCCCTTAGAAGTTAAACA -> TCCCTTAGAAGTTAAACAA
TACTGCATCTATCCTCAGA -> ACTGCATCTATCCTCAGAG
TCAGGTTAAGCTGCCGAGG -> CAGGTTAAGCTGCCGAGGC
CGGTTCTTAGTACGACGCG -> GGTTCTTAGTACGACGCGT
GGCGAGGGTAAATCAATTC -> GCGAGGGTAAATCAATTCA
ACAGCTGGCTCGCAACCGC -> CAGCTGGCTCGCAACCGCA
TGGCGCGCCTATACTACAG -> GGCGCGCCTATACTACAGC
AGTTGGTTGAGGAACCGTG -> GTTGGTTGAGGAACCGTGA
CCGTTTCCTTCATGTTAGC -> CGTTTCCTTCATGTTAGCT
CACCTGGAGCGCTTTAAAA -> ACCTGGAGCGCTTTAAAAC
GCCTCAATGGAGGGGTTCC -> CCTCAATGGAGGGGTTCCG
CTATGTCGCGTCCCTGCAT -> TATGTCGCGTCCCTGCATA
ACGGGCACGGGGAGCATAA -> CGGGCACGGGGAGCATAAG
GCGCCTCGGTATTTCTGAC -> CGCCTCGGTATTTCTGACG
CTTGTCCACATTTAAAAAC -> TTGTCCACATTTAAAAACT
CTCCAACCGTGGACCGCCG -> TCCAACCGTGGACCGCCGT
ATATCGCTTTGTTGATAAT -> TATCGCTTTGTTGATAATC
ACAGCAGTATGGGCGCAAT -> CAGCAGTATGGGCGCAATA
TAATCACAGCAGTATGGGC -> AATCACAGCAGTATGGGCG
AGGACCTGTGTTACCGTCC -> GGACCTGTGTTACCGTCCG
GACGCTTCGTATAGAGCAA -> ACGCTTCGTATAGAGCAAG
GCCTCGGTATTTCTGACGG -> CCTCGGTATTTCTGACGGC
CCATTCGAGAAGTTCCCTC -> CATTCGAGAAGTTCCCTCA
AGGGTAAATCAATTCATAT -> GGGTAAATCAATTCATATC
ACGGTTTGTACTAACGGAG -> CGGTTTGTACTAACGGAGG
GCAAGGACCTGTGTTACCG -> CAAGGACCTGTGTTACCGT
TCGTGCAAGCTGTCTTCAA -> CGTGCAAGCTGTCTTCAAC
TATCCCAGAGCTTCTTCTC -> ATCCCAGAGCTTCTTCTCG
TGGTTCCTACCTTCTGAAC -> GGTTCCTACCTTCTGAACT
AAGGACCTGTGTTACCGTC -> AGGACCTGTGTTACCGTCC
GGCTGAGACCTGATTAGGG -> GCTGAGACCTGATTAGGGA
CGTGCCTTGGAAATGAGGA -> GTGCCTTGGAAATGAGGAG
TATACACCGCTAGATAGTG -> ATACACCGCTAGATAGTGC
CATCTGAGTTGCGAATGGC -> ATCTGAGTTGCGAATGGCG
GTCAGCAGAATGCGAGTGG -> TCAGCAGAATGCGAGTGGC
GTTGCCGAAATCGTCTTTG -> TTGCCGAAATCGTCTTTGC
TATCAGTCGATTCCCTACC -> ATCAGTCGATTCCCTACCT
GGAGGCATCCATTCCCCCC -> GAGGCATCCATTCCCCCCA
AAATTTATGGCAAGGACCT -> AATTTATGGCAAGGACCTG
GCCCTACGCCTAGCAGCTG -> CCCTACGCCTAGCAGCTGA
TGCCCACGATATCGCTTTG -> GCCCACGATATCGCTTTGT
TCCCGTGCCCACGATATCG -> CCCGTGCCCACGATATCGC
GGCGGAGGACTTATTACAA -> GCGGAGGACTTATTACAAT
GAGGTGCGTAATTCAAGAT -> AGGTGCGTAATTCAAGATC
GGTTGTTCGCGAAAAGAGG -> GTTGTTCGCGAAAAGAGGA
TGTCCAAGTTGGTTGAGGA -> GTCCAAGTTGGTTGAGGAA
AGCAGTATGGGCGCAATAT -> GCAGTATGGGCGCAATATC
TGGAAATGAGGAGGCGCGT -> GGAAATGAGGAGGCGCGTT
GATCGTAACATGTGTAGAC -> ATCGTAACATGTGTAGACA
AAATGAGGAGGCGCGTTTT -> AATGAGGAGGCGCGTTTTG
TTCAACGGGCACGGGGAGC -> TCAACGGGCACGGGGAGCA
CTATCCTCAGAGAAAACCG -> TATCCTCAGAGAAAACCGG
TCTTGGCGAGGGTAAATCA -> CTTGGCGAGGGTAAATCAA
CATGTCGTCAGCAGAATGC -> ATGTCGTCAGCAGAATGCG
GGGAATTAGTAACGCGCCT -> GGAATTAGTAACGCGCCTC
GGGTGAGCAAACGGCGTGC -> GGTGAGCAAACGGCGTGCT
AACTATGTCGCGTCCCTGC -> ACTATGTCGCGTCCCTGCA
CTGAGGGTTGTTCGCGAAA -> TGAGGGTTGTTCGCGAAAA
GCTCCTACCCCAATAATTT -> CTCCTACCCCAATAATTTT
TCTGTGCATTACGATGAAA -> CTGTGCATTACGATGAAAC
TCGTTGAATCACGGAATCT -> CGTTGAATCACGGAATCTT
ACTCGTGCAAGCTGTCTTC -> CTCGTGCAAGCTGTCTTCA
GGATATCACCTCAATACTT -> GATATCACCTCAATACTTG
GGCGTACTCGTGCAAGCTG -> GCGTACTCGTGCAAGCTGT
AGCTGTGCCATAACCCTCC -> GCTGTGCCATAACCCTCCT
CACGATGCCTCCCGTGCCC -> ACGATGCCTCCCGTGCCCA
CTGCTGCAGTCAGGTTAAG -> TGCTGCAGTCAGGTTAAGC
TCATCATTGAGGTGCGTAA -> CATCATTGAGGTGCGTAAT
TGAGTGCGAACTGTGGGAC -> GAGTGCGAACTGTGGGACA
GTCCGTTGCCGAAATCGTC -> TCCGTTGCCGAAATCGTCT
AAGGGCCTCACGGTACCGA -> AGGGCCTCACGGTACCGAG
CGAACTGTGGGACAATATA -> GAACTGTGGGACAATATAC
ACGGAGGCATCCATTCCCC -> CGGAGGCATCCATTCCCCC
ATAGCATGTCGTCATCATT -> TAGCATGTCGTCATCATTG
CCCGTCTGTGCATTACGAT -> CCGTCTGTGCATTACGATG
TGAATCACGGAATCTTAAT -> GAATCACGGAATCTTAATT
GACCGCCGTGCGCCTCGGT -> ACCGCCGTGCGCCTCGGTA
TAATTCATACCGCAAACGG -> AATTCATACCGCAAACGGT
GCTAACCTACCTTCTGAAC -> CTAACCTACCTTCTGAACT
CCTCACGGTACCGAGGTAG -> CTCACGGTACCGAGGTAGG
AGATGTGAGTTGAGTGCGA -> GATGTGAGTTGAGTGCGAA
GTAACGCGCCTCGTCATCC -> TAACGCGCCTCGTCATCCT
CGCTTATAGAGGTCACAGT -> GCTTATAGAGGTCACAGTG
GGGGTACGCTCGGTCCCGC -> GGGTACGCTCGGTCCCGCA
TAGTGCAGGGCTGGGCAGA -> AGTGCAGGGCTGGGCAGAT
CATGTCGTCATCATTGAGG -> ATGTCGTCATCATTGAGGT
CTAGCTTATAGCATGTCGT -> TAGCTTATAGCATGTCGTC
CCGCTGAGCGTTGCTTTAG -> CGCTGAGCGTTGCTTTAGC
TGCGAACTGTGGGACAATA -> GCGAACTGTGGGACAATAT
GCGTAGTAAATTTATGGCA -> CGTAGTAAATTTATGGCAA
AACCGTGACCATGGCGTAC -> ACCGTGACCATGGCGTACT
GACATTGCTCAGGGCACCT -> ACATTGCTCAGGGCACCTT
GCTGAGGGTTGTTCGCGAA -> CTGAGGGTTGTTCGCGAAA
CAATCCTCAGGTCCTTCTG -> AATCCTCAGGTCCTTCTGC
GCAGGGCTGGGCAGATGTG -> CAGGGCTGGGCAGATGTGA
CTAGTTGCCTACCTTCTGA -> TAGTTGCCTACCTTCTGAA
CAATGGAGGGGTTCCGCCC -> AATGGAGGGGTTCCGCCCG
CCTTCTGAACTATGACGGG -> CTTCTGAACTATGACGGGG
TGAACTATGGAGCGGCTAT -> GAACTATGGAGCGGCTATC
GTTCTTAGTACGACGCGTA -> TTCTTAGTACGACGCGTAT
TTCGTCTATGAGAATTGCA -> TCGTCTATGAGAATTGCAC
CTTATTACAATGCCTCAAT -> TTATTACAATGCCTCAATG
CCTAGCTTATAGCATGTCG -> CTAGCTTATAGCATGTCGT
ACTTGTCCACATTTAAAAA -> CTTGTCCACATTTAAAAAC
TCAGTATGGCATCGAGCAC -> CAGTATGGCATCGAGCACC
TCACAGTGCTGAGGGTTGT -> CACAGTGCTGAGGGTTGTT
ACGTTCCAGTACCGTTTCC -> CGTTCCAGTACCGTTTCCT
TATAGAGCAAGATTATGAC -> ATAGAGCAAGATTATGACG
CGAAATCGTCTTTGCGTAG -> GAAATCGTCTTTGCGTAGT
AAGTGACGCCACTTTTCTG -> AGTGACGCCACTTTTCTGT
GCAAACGTGAAGTTGCTGT -> CAAACGTGAAGTTGCTGTA
TCCTCAGGTCCTTCTGCTG -> CCTCAGGTCCTTCTGCTGC
TTCTGAACTATGCGCTTCA -> TCTGAACTATGCGCTTCAC
GCAGCTGAATATCCCAGAG -> CAGCTGAATATCCCAGAGC
GAGCCTGGCTGAGACCTGA -> AGCCTGGCTGAGACCTGAT
CCTCCCGTGCCCACGATAT -> CTCCCGTGCCCACGATATC
CGTGCGGTTCTTAGTACGA -> GTGCGGTTCTTAGTACGAC
CAGATGTGAGTTGAGTGCG -> AGATGTGAGTTGAGTGCGA
ACGGCGACTAGCTACATTA -> CGGCGACTAGCTACATTAT
AACTTGGGCACCGATGGTT -> ACTTGGGCACCGATGGTTC
TGCTGCAGTCAGGTTAAGC -> GCTGCAGTCAGGTTAAGCT
ATGGAGCGGCTATCCATAA -> TGGAGCGGCTATCCATAAT
GTAACACGTCTGTGCGGAG -> TAACACGTCTGTGCGGAGT
AGGCAGACGCTTCGTATAG -> GGCAGACGCTTCGTATAGA
TCTATCACCTAAGACGTTG -> CTATCACCTAAGACGTTGG
GCGCTTTAAAACTACACTG -> CGCTTTAAAACTACACTGC
TCAGAGAAAACCGGTAATA -> CAGAGAAAACCGGTAATAG
ACACGATGCCTCCCGTGCC -> CACGATGCCTCCCGTGCCC
TAAGTGACGCCACTTTTCT -> AAGTGACGCCACTTTTCTG
GTACTGCATCTATCCTCAG -> TACTGCATCTATCCTCAGA
AGCTGTCTTCAACGGGCAC -> GCTGTCTTCAACGGGCACG
CTCGATGGAATCGCTGTAA -> TCGATGGAATCGCTGTAAT
TTATCCTAACGAACAATTT -> TATCCTAACGAACAATTTT
GTACGCTCGGTCCCGCAGA -> TACGCTCGGTCCCGCAGAT
CACCGTCATAATTCATACC -> ACCGTCATAATTCATACCG
CAGCTGGCTCGCAACCGCA -> AGCTGGCTCGCAACCGCAC
CCAGAGGACTGTCCAAGTT -> CAGAGGACTGTCCAAGTTG
TATTACAATGCCTCAATGG -> ATTACAATGCCTCAATGGA
CATGAATCCTCGTGCGAAG -> ATGAATCCTCGTGCGAAGA
CACAATAACATTCTTATAC -> ACAATAACATTCTTATACC
GTACCGAGGTAGGATTCGT -> TACCGAGGTAGGATTCGTC
TAGCAGCTGAATATCCCAG -> AGCAGCTGAATATCCCAGA
ATACATCAGCTGTGCCATA -> TACATCAGCTGTGCCATAA
AATTTATGGCAAGGACCTG -> ATTTATGGCAAGGACCTGT
ATAACCCTCCTGTTCGGCA -> TAACCCTCCTGTTCGGCAC
CTATGGAGCGGCTATCCAT -> TATGGAGCGGCTATCCATA
TAAATCAATTCATATCTGT -> AAATCAATTCATATCTGTC
GGAGGACTTATTACAATGC -> GAGGACTTATTACAATGCC
CACGGAATCTTAATTGTTA -> ACGGAATCTTAATTGTTAT
AGTGGCTAGTTGCCTACCT -> GTGGCTAGTTGCCTACCTT
AATATCTCCAGCATGAATC -> ATATCTCCAGCATGAATCC
GGTTAAGCTGCCGAGGCAG -> GTTAAGCTGCCGAGGCAGA
AAACTACACTGCTGGAAAC -> AACTACACTGCTGGAAACC
AGATTCATCCGGCAAAGAG -> GATTCATCCGGCAAAGAGG
GAACTATGGAGCGGCTATC -> AACTATGGAGCGGCTATCC
GGTTTGTACTAACGGAGGC -> GTTTGTACTAACGGAGGCA
AACGGAGGCATCCATTCCC -> ACGGAGGCATCCATTCCCC
ATAACATTCTTATACCCGA -> TAACATTCTTATACCCGAT
GCCTGAACTATCGTGCAAA -> CCTGAACTATCGTGCAAAG
CTACGCCTAGCAGCTGAAT -> TACGCCTAGCAGCTGAATA
GTATTTAATCAGACGGCGA -> TATTTAATCAGACGGCGAC
CTGTTCGGCACAGCTGGCT -> TGTTCGGCACAGCTGGCTC
TTAGAAGTTAAACAAGGCA -> TAGAAGTTAAACAAGGCAG
TGGCCGGTAATCACAGCAG -> GGCCGGTAATCACAGCAGT
TAACACGTCTGTGCGGAGT -> AACACGTCTGTGCGGAGTC
CTGAACTATGCGCTTCACC -> TGAACTATGCGCTTCACCG
CTTCTGAACTATGACGGGG -> TTCTGAACTATGACGGGGT
AGAGGACTGTCCAAGTTGG -> GAGGACTGTCCAAGTTGGT
CGAGGGTAAATCAATTCAT -> GAGGGTAAATCAATTCATA
GCCTACCTTCTGAACTATG -> CCTACCTTCTGAACTATGG
GTCCAAGTTGGTTGAGGAA -> TCCAAGTTGGTTGAGGAAC
ATCTCCAGCATGAATCCTC -> TCTCCAGCATGAATCCTCG
CGATTACTGGGCGTGACAT -> GATTACTGGGCGTGACATT
ATCCTACAGAGAATTGCTC -> TCCTACAGAGAATTGCTCG
AAACCGCGAGCGTCTCACT -> AACCGCGAGCGTCTCACTA
GAACTATGTCGCGTCCCTG -> AACTATGTCGCGTCCCTGC
CTGCATCTATCCTCAGAGA -> TGCATCTATCCTCAGAGAA
ACAAGGCAGACGCTTCGTA -> CAAGGCAGACGCTTCGTAT
AGAAGTTAAACAAGGCAGA -> GAAGTTAAACAAGGCAGAC
ATGGTTCCTACCTTCTGAA -> TGGTTCCTACCTTCTGAAC
GACGGTTTGTACTAACGGA -> ACGGTTTGTACTAACGGAG
GTGCGAAGAGCATGATAGA -> TGCGAAGAGCATGATAGAG
GCATGTCGTCATCATTGAG -> CATGTCGTCATCATTGAGG
TCTATCCTCAGAGAAAACC -> CTATCCTCAGAGAAAACCG
TGGAATCGCTGTAATTTTA -> GGAATCGCTGTAATTTTAT
CACTGATGGCGTACTGCAT -> ACTGATGGCGTACTGCATC
ACTGGTGTTTCATGTCGTC -> CTGGTGTTTCATGTCGTCA
GGCCTCACGGTACCGAGGT -> GCCTCACGGTACCGAGGTA
ATCACCTAAGACGTTGGAA -> TCACCTAAGACGTTGGAAG
GCGCTCCTACCCCAATAAT -> CGCTCCTACCCCAATAATT
TGCCTCAATGGAGGGGTTC -> GCCTCAATGGAGGGGTTCC
GGTGAGCAAACGGCGTGCT -> GTGAGCAAACGGCGTGCTC
TGCCTGAACTATCGTGCAA -> GCCTGAACTATCGTGCAAA
CGCTCCTACCCCAATAATT -> GCTCCTACCCCAATAATTT
CATGTTAGCTACATCTGAG -> ATGTTAGCTACATCTGAGT
GAGTTCACCCCATCAGTAT -> AGTTCACCCCATCAGTATG
AGTGCAGGGCTGGGCAGAT -> GTGCAGGGCTGGGCAGATG
TAGAAGTTAAACAAGGCAG -> AGAAGTTAAACAAGGCAGA
ACCGATGGTTCCTACCTTC -> CCGATGGTTCCTACCTTCT
TTGGCGAGGGTAAATCAAT -> TGGCGAGGGTAAATCAATT
TGAATGCTGCGCATGCGTG -> GAATGCTGCGCATGCGTGT
GCTACATCTGAGTTGCGAA -> CTACATCTGAGTTGCGAAT
CGCCTATACTACAGCGCTC -> GCCTATACTACAGCGCTCC
CAGGGCTGGGCAGATGTGA -> AGGGCTGGGCAGATGTGAG
TCAAGATCTAACCCGCACA -> CAAGATCTAACCCGCACAT
ACCCTCCTGTTCGGCACAG -> CCCTCCTGTTCGGCACAGC
CTTTGCGTAGTAAATTTAT -> TTTGCGTAGTAAATTTATG
ACCAGCACGCTGGGGAATT -> CCAGCACGCTGGGGAATTA
GGCTCGCAACCGCACCTAG -> GCTCGCAACCGCACCTAGT
CTAGCTACATTATGTATAT -> TAGCTACATTATGTATATT
TCCCTGCATAATTCATACC -> CCCTGCATAATTCATACCG
TACAGAGAATTGCTCGAAC -> ACAGAGAATTGCTCGAACG
CAGAGCCTGGCTGAGACCT -> AGAGCCTGGCTGAGACCTG
TCTAACTTGGGCACCGATG -> CTAACTTGGGCACCGATGG
AGAATTGCACAATAACATT -> GAATTGCACAATAACATTC
AAAGAGGATGGCGCGCCTA -> AAGAGGATGGCGCGCCTAT
GAGTGGCTAGTTGCCTACC -> AGTGGCTAGTTGCCTACCT
AGAGCTTCTTCTCGATGGA -> GAGCTTCTTCTCGATGGAA
CTACACTGCTGGAAACCTT -> TACACTGCTGGAAACCTTA
CTCAGAGAAAACCGGTAAT -> TCAGAGAAAACCGGTAATA
AACGAACAATTTTGGCCGG -> ACGAACAATTTTGGCCGGT
CGAACGAGTGACGTTTGAT -> GAACGAGTGACGTTTGATT
TACTAACGGAGGCATCCAT -> ACTAACGGAGGCATCCATT
TGTAGACACGATGCCTCCC -> GTAGACACGATGCCTCCCG
CCTACCTTCTGAACTATGT -> CTACCTTCTGAACTATGTC
TATTAGTCCGTTGCCGAAA -> ATTAGTCCGTTGCCGAAAT
GCGTTCAATTATCAGTCGA -> CGTTCAATTATCAGTCGAT
AACGCGCCTCGTCATCCTA -> ACGCGCCTCGTCATCCTAC
ATGCTGCGCATGCGTGTCT -> TGCTGCGCATGCGTGTCTA
TTCCCCCCAACAATTCCAG -> TCCCCCCAACAATTCCAGG
GTCCTGATCGTAACATGTG -> TCCTGATCGTAACATGTGT
CCCCAACAATTCCAGGAGG -> CCCAACAATTCCAGGAGGC
CACTGCTGGAAACCTTACG -> ACTGCTGGAAACCTTACGG
TCTGAACTATGCGCTTCAC -> CTGAACTATGCGCTTCACC
AAACGTGCGGTTCTTAGTA -> AACGTGCGGTTCTTAGTAC
GCAATATCTCCAGCATGAA -> CAATATCTCCAGCATGAAT
TATCCTAACGAACAATTTT -> ATCCTAACGAACAATTTTG
TTGGAAGCCAGACAGCTCT -> TGGAAGCCAGACAGCTCTT
GCACGCTGGGGAATTAGTA -> CACGCTGGGGAATTAGTAA
GCGTGCTCCAACCGTGGAC -> CGTGCTCCAACCGTGGACC
GACGCCACTTTTCTGTACT -> ACGCCACTTTTCTGTACTC
GTGCCTTGGAAATGAGGAG -> TGCCTTGGAAATGAGGAGG
CATTGAGGTGCGTAATTCA -> ATTGAGGTGCGTAATTCAA
AATTGCCAGAGGACTGTCC -> ATTGCCAGAGGACTGTCCA
ATGACGCGATTACTGGGCG -> TGACGCGATTACTGGGCGT
ATATCTCCAGCATGAATCC -> TATCTCCAGCATGAATCCT
AGCCCTACGCCTAGCAGCT -> GCCCTACGCCTAGCAGCTG
CCTCAGGTCCTTCTGCTGC -> CTCAGGTCCTTCTGCTGCA
AGTTATTACGTGGATATCA -> GTTATTACGTGGATATCAC
AACTAAATGACGGTTTGTA -> ACTAAATGACGGTTTGTAC
CCTACCTTCTGAACTATGA -> CTACCTTCTGAACTATGAC
CGCACATCGAGAGTCTATC -> GCACATCGAGAGTCTATCA
CGCTTCACCGTCATAATTC -> GCTTCACCGTCATAATTCA
CAATTGCCAGAGGACTGTC -> AATTGCCAGAGGACTGTCC
ACGCGATTACTGGGCGTGA -> CGCGATTACTGGGCGTGAC
GCGCCTCGTCATCCTACAG -> CGCCTCGTCATCCTACAGA
CAATAACATTCTTATACCC -> AATAACATTCTTATACCCG
TAGTTGCCTACCTTCTGAA -> AGTTGCCTACCTTCTGAAC
AGTTGCGAATGGCGCTTAT -> GTTGCGAATGGCGCTTATA
ATAATTCATACCGCAAACA -> TAATTCATACCGCAAACAC
GAGAATTGCTCGAACGAGT -> AGAATTGCTCGAACGAGTG
GCTGGAAACCTTACGGATA -> CTGGAAACCTTACGGATAT
TTAAACAAGGCAGACGCTT -> TAAACAAGGCAGACGCTTC
GAACTATGCGCTTCACCGT -> AACTATGCGCTTCACCGTC
TACCTCCGTACCATAAACG -> ACCTCCGTACCATAAACGT
ATACTCTTGGCGAGGGTAA -> TACTCTTGGCGAGGGTAAA
ACCCCATCAGTATGGCATC -> CCCCATCAGTATGGCATCG
AATTCATACCGCAAACGGT -> ATTCATACCGCAAACGGTC
TACTCTTGGCGAGGGTAAA -> ACTCTTGGCGAGGGTAAAT
GTACTCGTGCAAGCTGTCT -> TACTCGTGCAAGCTGTCTT
AATTCATACCGCAAACTTG -> ATTCATACCGCAAACTTGT
TGACCATGGCGTACTCGTG -> GACCATGGCGTACTCGTGC
CAGAGCCAGAGCCTGGCTG -> AGAGCCAGAGCCTGGCTGA
AACAATTCCAGGAGGCAGA -> ACAATTCCAGGAGGCAGAG
GCCAGACAGCTCTTATACA -> CCAGACAGCTCTTATACAC
ATTAGTACGTCCGTGTGCC -> TTAGTACGTCCGTGTGCCC
CACCGATGGTTCCTACCTT -> ACCGATGGTTCCTACCTTC
GACCTGTGTTACCGTCCGC -> ACCTGTGTTACCGTCCGCG
ATGGCGCTTATAGAGGTCA -> TGGCGCTTATAGAGGTCAC
AATAACATTCTTATACCCG -> ATAACATTCTTATACCCGA
GAGAAAACCGGTAATAGAC -> AGAAAACCGGTAATAGACG
CTAACTTGGGCACCGATGG -> TAACTTGGGCACCGATGGT
AGTGACGTTTGATTACCTC -> GTGACGTTTGATTACCTCC
GACAATATACATCAGCTGT -> ACAATATACATCAGCTGTG
GCAGTCAGGTTAAGCTGCC -> CAGTCAGGTTAAGCTGCCG
AACCGGTAATAGACGTTAT -> ACCGGTAATAGACGTTATT
TAATCGTTGAATCACGGAA -> AATCGTTGAATCACGGAAT
AAACGTGAAGTTGCTGTAA -> AACGTGAAGTTGCTGTAAT
TGAACTATGCGCTTCACCG -> GAACTATGCGCTTCACCGT
CGCGCCTATACTACAGCGC -> GCGCCTATACTACAGCGCT
CCAACAATTCCAGGAGGCA -> CAACAATTCCAGGAGGCAG
TTCTGAACTATGACGGGGT -> TCTGAACTATGACGGGGTG
ATAGTGCAGGGCTGGGCAG -> TAGTGCAGGGCTGGGCAGA
TTGCTGTAATGCTATTTTC -> TGCTGTAATGCTATTTTCG
ACCCGCACATCGAGAGTCT -> CCCGCACATCGAGAGTCTA
GAACGTTCCAGTACCGTTT -> AACGTTCCAGTACCGTTTC
GACCATGGCGTACTCGTGC -> ACCATGGCGTACTCGTGCA
TTGTAACACGTCTGTGCGG -> TGTAACACGTCTGTGCGGA
TCATACCGCAAACTTGTCC -> CATACCGCAAACTTGTCCA
GCGTACTCGTGCAAGCTGT -> CGTACTCGTGCAAGCTGTC
GAGTTGCGAATGGCGCTTA -> AGTTGCGAATGGCGCTTAT
ATCACGGAATCTTAATTGT -> TCACGGAATCTTAATTGTT
CTACATTATGTATATTAGT -> TACATTATGTATATTAGTC
ATAATCGTTGAATCACGGA -> TAATCGTTGAATCACGGAA
AGTCTAGACTGGTGTTTCA -> GTCTAGACTGGTGTTTCAT
TATACATCAGCTGTGCCAT -> ATACATCAGCTGTGCCATA
GAAAACCGGTAATAGACGT -> AAAACCGGTAATAGACGTT
GAATCACGGAATCTTAATT -> AATCACGGAATCTTAATTG
TTCTTCTCGATGGAATCGC -> TCTTCTCGATGGAATCGCT
GGGGTTCCGCCCGTCTGTG -> GGGTTCCGCCCGTCTGTGC
CTGAACTATCGTGCAAAGA -> TGAACTATCGTGCAAAGAT
GGATACATCCGTGCCTTGG -> GATACATCCGTGCCTTGGA
TGGTGTTTCATGTCGTCAG -> GGTGTTTCATGTCGTCAGC
TCCGGCAAAGAGGCCGCTG -> CCGGCAAAGAGGCCGCTGA
TCAGGGCACCTTCCCGTCA -> CAGGGCACCTTCCCGTCAA
GCCAGAGGACTGTCCAAGT -> CCAGAGGACTGTCCAAGTT
TTATAGCATGTCGTCATCA -> TATAGCATGTCGTCATCAT
CCGATGGTTCCTACCTTCT -> CGATGGTTCCTACCTTCTG
TGTCGTCATCATTGAGGTG -> GTCGTCATCATTGAGGTGC
GGGGAGCATAAGTTTCTGC -> GGGAGCATAAGTTTCTGCG
TTGATAATCGTTGAATCAC -> TGATAATCGTTGAATCACG
CTTTGTTGATAATCGTTGA -> TTTGTTGATAATCGTTGAA
CATCCATTCCCCCCAACAA -> ATCCATTCCCCCCAACAAT
GACCCTCACCAGCACGCTG -> ACCCTCACCAGCACGCTGG
CACCTCAATACTTGTGCAA -> ACCTCAATACTTGTGCAAT
CGCGTATCAATCCTCAGGT -> GCGTATCAATCCTCAGGTC
GTCTTCAACGGGCACGGGG -> TCTTCAACGGGCACGGGGA
GCGTGGGGTACGCTCGGTC -> CGTGGGGTACGCTCGGTCC
AACTACACTGCTGGAAACC -> ACTACACTGCTGGAAACCT
TGGGACAATATACATCAGC -> GGGACAATATACATCAGCT
TAGTACGACGCGTATCAAT -> AGTACGACGCGTATCAATC
ACAGCTCTTATACACCGCT -> CAGCTCTTATACACCGCTA
GGCGCGCCTATACTACAGC -> GCGCGCCTATACTACAGCG
CATGTGTAGACACGATGCC -> ATGTGTAGACACGATGCCT
TTCCGCCCGTCTGTGCATT -> TCCGCCCGTCTGTGCATTA
ATTATGACGCGATTACTGG -> TTATGACGCGATTACTGGG
TTTCTGCGTTCAATTATCA -> TTCTGCGTTCAATTATCAG
TCTGAACTATGTCGCGTCC -> CTGAACTATGTCGCGTCCC
TCGTGCGAAGAGCATGATA -> CGTGCGAAGAGCATGATAG
CAGCAGAATGCGAGTGGCT -> AGCAGAATGCGAGTGGCTA
TTTCTGTACTCTAACTTGG -> TTCTGTACTCTAACTTGGG
CGTTGCTTTAGCGCAGCTA -> GTTGCTTTAGCGCAGCTAA
CCCCAATAATTTTCAAAAG -> CCCAATAATTTTCAAAAGT
ACGCTTCGTATAGAGCAAG -> CGCTTCGTATAGAGCAAGA
ACTTCTGAATGCTGCGCAT -> CTTCTGAATGCTGCGCATG
AGAGAATTGCTCGAACGAG -> GAGAATTGCTCGAACGAGT
GCTGCAGTCAGGTTAAGCT -> CTGCAGTCAGGTTAAGCTG
CCTTCCCGTCAAGGAACGT -> CTTCCCGTCAAGGAACGTT
TTCCCGTCAAGGAACGTTC -> TCCCGTCAAGGAACGTTCC
GACGGCGACTAGCTACATT -> ACGGCGACTAGCTACATTA
ACGATATCGCTTTGTTGAT -> CGATATCGCTTTGTTGATA
CCGTGCCTTGGAAATGAGG -> CGTGCCTTGGAAATGAGGA
TGCGAGTTGCCGAACTAAA -> GCGAGTTGCCGAACTAAAT
CTGGTGTTTCATGTCGTCA -> TGGTGTTTCATGTCGTCAG
GTGACGTTTGATTACCTCC -> TGACGTTTGATTACCTCCG
AATTGTTATTTGTAAGTGA -> ATTGTTATTTGTAAGTGAC
CTTCTGAACTATGGAGCGG -> TTCTGAACTATGGAGCGGC
TTATTAGTACGTCCGTGTG -> TATTAGTACGTCCGTGTGC
CCCATCAGTATGGCATCGA -> CCATCAGTATGGCATCGAG
CTACCTTCTGAACTATGAC -> TACCTTCTGAACTATGACG
GATGAAACCGCGAGCGTCT -> ATGAAACCGCGAGCGTCTC
TTTTCGGATGGATACATCC -> TTTCGGATGGATACATCCG
GGAAACCTTACGGATATTC -> GAAACCTTACGGATATTCC
GGCAGAGGCGGTCGGGTGA -> GCAGAGGCGGTCGGGTGAG
CGCCTCGGTATTTCTGACG -> GCCTCGGTATTTCTGACGG
TAACGGAGGCATCCATTCC -> AACGGAGGCATCCATTCCC
GACTTATTACAATGCCTCA -> ACTTATTACAATGCCTCAA
AATCACGGAATCTTAATTG -> ATCACGGAATCTTAATTGT
AAACTTCTGAATGCTGCGC -> AACTTCTGAATGCTGCGCA
ATTTATGGCAAGGACCTGT -> TTTATGGCAAGGACCTGTG
TGCTTTAGCGCAGCTAACC -> GCTTTAGCGCAGCTAACCT
GAGCTTCTTCTCGATGGAA -> AGCTTCTTCTCGATGGAAT
TGGCGAGGGTAAATCAATT -> GGCGAGGGTAAATCAATTC
CTCTTATACACCGCTAGAT -> TCTTATACACCGCTAGATA
TTGTAAGTGACGCCACTTT -> TGTAAGTGACGCCACTTTT
TTGTTGATAATCGTTGAAT -> TGTTGATAATCGTTGAATC
TTTAAAACTACACTGCTGG -> TTAAAACTACACTGCTGGA
CGGAGGACTTATTACAATG -> GGAGGACTTATTACAATGC
CTAGATAGTGCAGGGCTGG -> TAGATAGTGCAGGGCTGGG
TAAGCTGCCGAGGCAGAGG -> AAGCTGCCGAGGCAGAGGC
GCCGAGGCAGAGGCGGTCG -> CCGAGGCAGAGGCGGTCGG
ATGGCAAGGACCTGTGTTA -> TGGCAAGGACCTGTGTTAC
CATTGCTCAGGGCACCTTC -> ATTGCTCAGGGCACCTTCC
TGTGCCCTAGCTTATAGCA -> GTGCCCTAGCTTATAGCAT
GTTGAGTGCGAACTGTGGG -> TTGAGTGCGAACTGTGGGA
CGCCGTGCGCCTCGGTATT -> GCCGTGCGCCTCGGTATTT
CTCGCAACCGCACCTAGTT -> TCGCAACCGCACCTAGTTT
GGCACTGATGGCGTACTGC -> GCACTGATGGCGTACTGCA
ACTAGCTACATTATGTATA -> CTAGCTACATTATGTATAT
CATTCGAGAAGTTCCCTCA -> ATTCGAGAAGTTCCCTCAG
CTTTAGCGCAGCTAACCTA -> TTTAGCGCAGCTAACCTAC
GCTGGGCAGATGTGAGTTG -> CTGGGCAGATGTGAGTTGA
TAGCTACATCTGAGTTGCG -> AGCTACATCTGAGTTGCGA
TCATGTGACCCTCACCAGC -> CATGTGACCCTCACCAGCA
TGCTGAGGGTTGTTCGCGA -> GCTGAGGGTTGTTCGCGAA
TGCACAATAACATTCTTAT -> GCACAATAACATTCTTATA
GGTTGAGGAACCGTGACCA -> GTTGAGGAACCGTGACCAT
GCCGAAATCGTCTTTGCGT -> CCGAAATCGTCTTTGCGTA
ATTACGTGGATATCACCTC -> TTACGTGGATATCACCTCA
TCGTGCAAAGATCCAATTG -> CGTGCAAAGATCCAATTGC
CAGACAGCTCTTATACACC -> AGACAGCTCTTATACACCG
CGAGTTGCCGAACTAAATG -> GAGTTGCCGAACTAAATGA
GCAAAGAGGCCGCTGAGCG -> CAAAGAGGCCGCTGAGCGT
ATTCTTATACCCGATCGCC -> TTCTTATACCCGATCGCCC
AGAGAAAACCGGTAATAGA -> GAGAAAACCGGTAATAGAC
ATAATTTTCAAAAGTTATT -> TAATTTTCAAAAGTTATTA
CAAGATTATGACGCGATTA -> AAGATTATGACGCGATTAC
TTCGGCACAGCTGGCTCGC -> TCGGCACAGCTGGCTCGCA
TTCGCGAAAAGAGGATGGC -> TCGCGAAAAGAGGATGGCG
TGACGGCGGAGGACTTATT -> GACGGCGGAGGACTTATTA
GTACTCTAACTTGGGCACC -> TACTCTAACTTGGGCACCG
CCGTTGCCGAAATCGTCTT -> CGTTGCCGAAATCGTCTTT
TAGAGGCACTGATGGCGTA -> AGAGGCACTGATGGCGTAC
AGAGTCTATCACCTAAGAC -> GAGTCTATCACCTAAGACG
TCCTCGTGCGAAGAGCATG -> CCTCGTGCGAAGAGCATGA
CTACCTTCTGAACTATGTC -> TACCTTCTGAACTATGTCG
ATCAATTCATATCTGTCGG -> TCAATTCATATCTGTCGGG
GTATGGGCGCAATATCTCC -> TATGGGCGCAATATCTCCA
CAATATCTCCAGCATGAAT -> AATATCTCCAGCATGAATC
CCTTCTGAACTATGCGCTT -> CTTCTGAACTATGCGCTTC
CCATAAACGTGCGGTTCTT -> CATAAACGTGCGGTTCTTA
TGTAAGTGACGCCACTTTT -> GTAAGTGACGCCACTTTTC
AATTTTATCCTAACGAACA -> ATTTTATCCTAACGAACAA
CATAACCCTCCTGTTCGGC -> ATAACCCTCCTGTTCGGCA
TGCAAGCTGTCTTCAACGG -> GCAAGCTGTCTTCAACGGG
GACGGCGGAGGACTTATTA -> ACGGCGGAGGACTTATTAC
ACGACGCGTATCAATCCTC -> CGACGCGTATCAATCCTCA
CGAGAAGTTCCCTCAGAGC -> GAGAAGTTCCCTCAGAGCC
CCTTAGAAGTTAAACAAGG -> CTTAGAAGTTAAACAAGGC
TGTTCGCGAAAAGAGGATG -> GTTCGCGAAAAGAGGATGG
CGTGCGCCTCGGTATTTCT -> GTGCGCCTCGGTATTTCTG
CCTTCTGCTGCAGTCAGGT -> CTTCTGCTGCAGTCAGGTT
GTTGCGAATGGCGCTTATA -> TTGCGAATGGCGCTTATAG
AGGACTTATTACAATGCCT -> GGACTTATTACAATGCCTC
GTCGGGTGAGCAAACGGCG -> TCGGGTGAGCAAACGGCGT
AACCTTACGGATATTCCCC -> ACCTTACGGATATTCCCCT
TTGCTTTAGCGCAGCTAAC -> TGCTTTAGCGCAGCTAACC
ACGGTCCTGATCGTAACAT -> CGGTCCTGATCGTAACATG
CGTCTGTGCGGAGTCTAGA -> GTCTGTGCGGAGTCTAGAC
ACGTCCGTGTGCCCTAGCT -> CGTCCGTGTGCCCTAGCTT
AACAAGGCAGACGCTTCGT -> ACAAGGCAGACGCTTCGTA
TGGAGCGGCTATCCATAAT -> GGAGCGGCTATCCATAATT
CTATGCGCTTCACCGTCAT -> TATGCGCTTCACCGTCATA
CATATCTGTCGGGAGTTCA -> ATATCTGTCGGGAGTTCAC
CGCGCCTCGTCATCCTACA -> GCGCCTCGTCATCCTACAG
TGTGCCATAACCCTCCTGT -> GTGCCATAACCCTCCTGTT
GCATCCATTCCCCCCAACA -> CATCCATTCCCCCCAACAA
CCTACAGAGAATTGCTCGA -> CTACAGAGAATTGCTCGAA
CGTGCAAGCTGTCTTCAAC -> GTGCAAGCTGTCTTCAACG
AGAATGCGAGTTGCCGAAC -> GAATGCGAGTTGCCGAACT
AATTTTGGCCGGTAATCAC -> ATTTTGGCCGGTAATCACA
CCTAGTTTGCCTGAACTAT -> CTAGTTTGCCTGAACTATC
GCGATTACTGGGCGTGACA -> CGATTACTGGGCGTGACAT
ATGACGGGGTGAACCATAA -> TGACGGGGTGAACCATAAT
CTAGACTGGTGTTTCATGT -> TAGACTGGTGTTTCATGTC
CACCGCTAGATAGTGCAGG -> ACCGCTAGATAGTGCAGGG
GAGGCAGAGGCGGTCGGGT -> AGGCAGAGGCGGTCGGGTG
GCACTGATGGCGTACTGCA -> CACTGATGGCGTACTGCAT
GTTTTGTAACACGTCTGTG -> TTTTGTAACACGTCTGTGC
GGGTTGTTCGCGAAAAGAG -> GGTTGTTCGCGAAAAGAGG
GATATCGCTTTGTTGATAA -> ATATCGCTTTGTTGATAAT
ACCGCCGTGCGCCTCGGTA -> CCGCCGTGCGCCTCGGTAT
AGCTTATAGCATGTCGTCA -> GCTTATAGCATGTCGTCAT
AGGCCGCTGAGCGTTGCTT -> GGCCGCTGAGCGTTGCTTT
TACCGCAAACGGTCCTGAT -> ACCGCAAACGGTCCTGATC
TGGGGTACGCTCGGTCCCG -> GGGGTACGCTCGGTCCCGC
CCGCCGTGCGCCTCGGTAT -> CGCCGTGCGCCTCGGTATT
AGCAAACGGCGTGCTCCAA -> GCAAACGGCGTGCTCCAAC
TCAGACGGCGACTAGCTAC -> CAGACGGCGACTAGCTACA
TACCGTCCGCGATCCCTTA -> ACCGTCCGCGATCCCTTAG
CTGGCTGAGACCTGATTAG -> TGGCTGAGACCTGATTAGG
ATTCATATCTGTCGGGAGT -> TTCATATCTGTCGGGAGTT
CTTCAACGGGCACGGGGAG -> TTCAACGGGCACGGGGAGC
CAAAGAGGCCGCTGAGCGT -> AAAGAGGCCGCTGAGCGTT
CTGTCGGGAGTTCACCCCA -> TGTCGGGAGTTCACCCCAT
TATACCCGATCGCCCGCGT -> ATACCCGATCGCCCGCGTG
TATGCGCTTCACCGTCATA -> ATGCGCTTCACCGTCATAA
CGAACAATTTTGGCCGGTA -> GAACAATTTTGGCCGGTAA
TCGAGAAGTTCCCTCAGAG -> CGAGAAGTTCCCTCAGAGC
CTCCCGTGCCCACGATATC -> TCCCGTGCCCACGATATCG
GTCCCTGCATAATTCATAC -> TCCCTGCATAATTCATACC
TTTGATTACCTCCGTACCA -> TTGATTACCTCCGTACCAT
GGGCTGGGCAGATGTGAGT -> GGCTGGGCAGATGTGAGTT
CCAGGAGGCAGAGCCATTC -> CAGGAGGCAGAGCCATTCG
TGTTTCATGTCGTCAGCAG -> GTTTCATGTCGTCAGCAGA
TTGGAAATGAGGAGGCGCG -> TGGAAATGAGGAGGCGCGT
CGATGGTTCCTACCTTCTG -> GATGGTTCCTACCTTCTGA
GTGAGCAAACGGCGTGCTC -> TGAGCAAACGGCGTGCTCC
CTGAATGCTGCGCATGCGT -> TGAATGCTGCGCATGCGTG
TTCCTACCTTCTGAACTAT -> TCCTACCTTCTGAACTATG
GCTTCTTCTCGATGGAATC -> CTTCTTCTCGATGGAATCG
GGATGGCGCGCCTATACTA -> GATGGCGCGCCTATACTAC
ATATCACCTCAATACTTGT -> TATCACCTCAATACTTGTG
GAACAATTTTGGCCGGTAA -> AACAATTTTGGCCGGTAAT
GGCAAAGAGGCCGCTGAGC -> GCAAAGAGGCCGCTGAGCG
GCTACATTATGTATATTAG -> CTACATTATGTATATTAGT
CACAGCAGTATGGGCGCAA -> ACAGCAGTATGGGCGCAAT
CGCGATCCCTTAGAAGTTA -> GCGATCCCTTAGAAGTTAA
GCATCTATCCTCAGAGAAA -> CATCTATCCTCAGAGAAAA
CTCGGTCCCGCAGATTCAT -> TCGGTCCCGCAGATTCATC
CTCCTGTTCGGCACAGCTG -> TCCTGTTCGGCACAGCTGG
AAGTTCCCTCAGAGCCAGA -> AGTTCCCTCAGAGCCAGAG
CCGTGACCATGGCGTACTC -> CGTGACCATGGCGTACTCG
GTAAATCAATTCATATCTG -> TAAATCAATTCATATCTGT
ATGGAGGGGTTCCGCCCGT -> TGGAGGGGTTCCGCCCGTC
CACCTAGTTTGCCTGAACT -> ACCTAGTTTGCCTGAACTA
CAGTCAGGTTAAGCTGCCG -> AGTCAGGTTAAGCTGCCGA
GTCATCATTGAGGTGCGTA -> TCATCATTGAGGTGCGTAA
GTACGTCCGTGTGCCCTAG -> TACGTCCGTGTGCCCTAGC
GAGTCTATCACCTAAGACG -> AGTCTATCACCTAAGACGT
TCGTAACATGTGTAGACAC -> CGTAACATGTGTAGACACG
TGGTTGAGGAACCGTGACC -> GGTTGAGGAACCGTGACCA
CGGGTGAGCAAACGGCGTG -> GGGTGAGCAAACGGCGTGC
CCGCAAACTTGTCCACATT -> CGCAAACTTGTCCACATTT
TACGCCTAGCAGCTGAATA -> ACGCCTAGCAGCTGAATAT
GTATCAATCCTCAGGTCCT -> TATCAATCCTCAGGTCCTT
CTTCATGTTAGCTACATCT -> TTCATGTTAGCTACATCTG
GCAACCGCACCTAGTTTGC -> CAACCGCACCTAGTTTGCC
CTTATAGAGGTCACAGTGC -> TTATAGAGGTCACAGTGCT
CTCTTGGCGAGGGTAAATC -> TCTTGGCGAGGGTAAATCA
TTCGAGAAGTTCCCTCAGA -> TCGAGAAGTTCCCTCAGAG
CTTAGTACGACGCGTATCA -> TTAGTACGACGCGTATCAA
CAGAGGACTGTCCAAGTTG -> AGAGGACTGTCCAAGTTGG
TGTCGCGTCCCTGCATAAT -> GTCGCGTCCCTGCATAATT
GATCGCCCGCGTGGGGTAC -> ATCGCCCGCGTGGGGTACG
TACGACGCGTATCAATCCT -> ACGACGCGTATCAATCCTC
GGTGTTTCATGTCGTCAGC -> GTGTTTCATGTCGTCAGCA
AGATTATGACGCGATTACT -> GATTATGACGCGATTACTG
CCTAGCAGCTGAATATCCC -> CTAGCAGCTGAATATCCCA
GTCATCCTACAGAGAATTG -> TCATCCTACAGAGAATTGC
TGGATACATCCGTGCCTTG -> GGATACATCCGTGCCTTGG
AAAACTACACTGCTGGAAA -> AAACTACACTGCTGGAAAC
GGTCACAGTGCTGAGGGTT -> GTCACAGTGCTGAGGGTTG
CAAACGGCGTGCTCCAACC -> AAACGGCGTGCTCCAACCG
TTTGCGTAGTAAATTTATG -> TTGCGTAGTAAATTTATGG
CCGTGTGCCCTAGCTTATA -> CGTGTGCCCTAGCTTATAG
GTTGAGGAACCGTGACCAT -> TTGAGGAACCGTGACCATG
GGGAGTTCACCCCATCAGT -> GGAGTTCACCCCATCAGTA
ACCGTCATAATTCATACCG -> CCGTCATAATTCATACCGC
ACTGATGGCGTACTGCATC -> CTGATGGCGTACTGCATCT
CTTAGAAGTTAAACAAGGC -> TTAGAAGTTAAACAAGGCA
AACTATCGTGCAAAGATCC -> ACTATCGTGCAAAGATCCA
CAGCTAACCTACCTTCTGA -> AGCTAACCTACCTTCTGAA
GGTAATCACAGCAGTATGG -> GTAATCACAGCAGTATGGG
GCTGGGGAATTAGTAACGC -> CTGGGGAATTAGTAACGCG
GATGGATACATCCGTGCCT -> ATGGATACATCCGTGCCTT
CATCGAGCACCTGGAGCGC -> ATCGAGCACCTGGAGCGCT
CGTGGATATCACCTCAATA -> GTGGATATCACCTCAATAC
ATCCATTCCCCCCAACAAT -> TCCATTCCCCCCAACAATT
GTATTTCTGACGGCGGAGG -> TATTTCTGACGGCGGAGGA
ACCGCGAGCGTCTCACTAG -> CCGCGAGCGTCTCACTAGA
GAGCATAAGTTTCTGCGTT -> AGCATAAGTTTCTGCGTTC
AGCATGAATCCTCGTGCGA -> GCATGAATCCTCGTGCGAA
CGTGTGCCCTAGCTTATAG -> GTGTGCCCTAGCTTATAGC
GTGCGGAGTCTAGACTGGT -> TGCGGAGTCTAGACTGGTG
GTTGCCTACCTTCTGAACT -> TTGCCTACCTTCTGAACTA
TTTCCTTCATGTTAGCTAC -> TTCCTTCATGTTAGCTACA
AGAATGCGAGTGGCTAGTT -> GAATGCGAGTGGCTAGTTG
ACTGCTGGAAACCTTACGG -> CTGCTGGAAACCTTACGGA
TAGTAAATTTATGGCAAGG -> AGTAAATTTATGGCAAGGA
TTGTGCAATACTCTTGGCG -> TGTGCAATACTCTTGGCGA
ATCTGTCGGGAGTTCACCC -> TCTGTCGGGAGTTCACCCC
CATGATAGAGGCACTGATG -> ATGATAGAGGCACTGATGG
GTGCAGGGCTGGGCAGATG -> TGCAGGGCTGGGCAGATGT
TTATTACGTGGATATCACC -> TATTACGTGGATATCACCT
TGCTCCAACCGTGGACCGC -> GCTCCAACCGTGGACCGCC
GAAAAGAGGATGGCGCGCC -> AAAAGAGGATGGCGCGCCT
AGCATAAGTTTCTGCGTTC -> GCATAAGTTTCTGCGTTCA
ATGCTATTTTCGGATGGAT -> TGCTATTTTCGGATGGATA
ATTATCAGTCGATTCCCTA -> TTATCAGTCGATTCCCTAC
TATAGCATGTCGTCATCAT -> ATAGCATGTCGTCATCATT
GTTCGGCACAGCTGGCTCG -> TTCGGCACAGCTGGCTCGC
AGAAGTTCCCTCAGAGCCA -> GAAGTTCCCTCAGAGCCAG
CAATTATCAGTCGATTCCC -> AATTATCAGTCGATTCCCT
GATTACCTCCGTACCATAA -> ATTACCTCCGTACCATAAA
TTATAGAGGTCACAGTGCT -> TATAGAGGTCACAGTGCTG
ATTGTTATTTGTAAGTGAC -> TTGTTATTTGTAAGTGACG
GGGCAGATGTGAGTTGAGT -> GGCAGATGTGAGTTGAGTG
CTGTCTTCAACGGGCACGG -> TGTCTTCAACGGGCACGGG
GTCGTCATCATTGAGGTGC -> TCGTCATCATTGAGGTGCG
TAGCATGTCGTCATCATTG -> AGCATGTCGTCATCATTGA
TGTGCGGAGTCTAGACTGG -> GTGCGGAGTCTAGACTGGT
GATAGTGCAGGGCTGGGCA -> ATAGTGCAGGGCTGGGCAG
AACAATTTTGGCCGGTAAT -> ACAATTTTGGCCGGTAATC
CCGCCCGTCTGTGCATTAC -> CGCCCGTCTGTGCATTACG
TTCAATTATCAGTCGATTC -> TCAATTATCAGTCGATTCC
GACTGTCCAAGTTGGTTGA -> ACTGTCCAAGTTGGTTGAG
ATGGGCGCAATATCTCCAG -> TGGGCGCAATATCTCCAGC
GGAGTTCACCCCATCAGTA -> GAGTTCACCCCATCAGTAT
TACATAGTCATGTGACCCT -> ACATAGTCATGTGACCCTC
AGTCATGTGACCCTCACCA -> GTCATGTGACCCTCACCAG
GGAATTAGTAACGCGCCTC -> GAATTAGTAACGCGCCTCG
CCACGATATCGCTTTGTTG -> CACGATATCGCTTTGTTGA
ACACTGCTGGAAACCTTAC -> CACTGCTGGAAACCTTACG
CAATTCCAGGAGGCAGAGC -> AATTCCAGGAGGCAGAGCC
AGGCAGAGGCGGTCGGGTG -> GGCAGAGGCGGTCGGGTGA
ATGCCTCAATGGAGGGGTT -> TGCCTCAATGGAGGGGTTC
CGGTAATCACAGCAGTATG -> GGTAATCACAGCAGTATGG
ACTACACTGCTGGAAACCT -> CTACACTGCTGGAAACCTT
TGCCGAGGCAGAGGCGGTC -> GCCGAGGCAGAGGCGGTCG
GGAGTCTAGACTGGTGTTT -> GAGTCTAGACTGGTGTTTC
TCTTCTCGATGGAATCGCT -> CTTCTCGATGGAATCGCTG
ACATGTGTAGACACGATGC -> CATGTGTAGACACGATGCC
GAGTTGAGTGCGAACTGTG -> AGTTGAGTGCGAACTGTGG
CGTAACATGTGTAGACACG -> GTAACATGTGTAGACACGA
CAGAATCAGCCCTACGCCT -> AGAATCAGCCCTACGCCTA
GGGGAATTAGTAACGCGCC -> GGGAATTAGTAACGCGCCT
TCCTGATCGTAACATGTGT -> CCTGATCGTAACATGTGTA
CAGAGCTTCTTCTCGATGG -> AGAGCTTCTTCTCGATGGA
TTAGTACGACGCGTATCAA -> TAGTACGACGCGTATCAAT
ATGGATACATCCGTGCCTT -> TGGATACATCCGTGCCTTG
CGTACTCGTGCAAGCTGTC -> GTACTCGTGCAAGCTGTCT
CTTCGTATAGAGCAAGATT -> TTCGTATAGAGCAAGATTA
GCGAGTTGCCGAACTAAAT -> CGAGTTGCCGAACTAAATG
GGGCGTGACATTGCTCAGG -> GGCGTGACATTGCTCAGGG
TTAAAAACTTCTGAATGCT -> TAAAAACTTCTGAATGCTG
TGTTACCGTCCGCGATCCC -> GTTACCGTCCGCGATCCCT
ATCAATCCTCAGGTCCTTC -> TCAATCCTCAGGTCCTTCT
ATCAGACGGCGACTAGCTA -> TCAGACGGCGACTAGCTAC
AGCTGCCGAGGCAGAGGCG -> GCTGCCGAGGCAGAGGCGG
CAATTTTGGCCGGTAATCA -> AATTTTGGCCGGTAATCAC
CGCGTCCCTGCATAATTCA -> GCGTCCCTGCATAATTCAT
ATAGTCATGTGACCCTCAC -> TAGTCATGTGACCCTCACC
CCGAACTAAATGACGGTTT -> CGAACTAAATGACGGTTTG
CAACCGCACCTAGTTTGCC -> AACCGCACCTAGTTTGCCT
TTAATTGTTATTTGTAAGT -> TAATTGTTATTTGTAAGTG
GTTCAATTATCAGTCGATT -> TTCAATTATCAGTCGATTC
TAAAACTACACTGCTGGAA -> AAAACTACACTGCTGGAAA
CGATATCGCTTTGTTGATA -> GATATCGCTTTGTTGATAA
CCCTTAGAAGTTAAACAAG -> CCTTAGAAGTTAAACAAGG
ACTAGAATGCGAGTTGCCG -> CTAGAATGCGAGTTGCCGA
GCCTCCCGTGCCCACGATA -> CCTCCCGTGCCCACGATAT
ACCTGTGTTACCGTCCGCG -> CCTGTGTTACCGTCCGCGA
TATCACCTAAGACGTTGGA -> ATCACCTAAGACGTTGGAA
AGAGCCTGGCTGAGACCTG -> GAGCCTGGCTGAGACCTGA
TGTTATTTGTAAGTGACGC -> GTTATTTGTAAGTGACGCC
CTGGAAACCTTACGGATAT -> TGGAAACCTTACGGATATT
TGTGCATTACGATGAAACC -> GTGCATTACGATGAAACCG
CTTCTGAATGCTGCGCATG -> TTCTGAATGCTGCGCATGC
TAGTTTGCCTGAACTATCG -> AGTTTGCCTGAACTATCGT
TTATACCCGATCGCCCGCG -> TATACCCGATCGCCCGCGT
ACGGTACCGAGGTAGGATT -> CGGTACCGAGGTAGGATTC
AGTTGCCGAACTAAATGAC -> GTTGCCGAACTAAATGACG
TTAATCAGACGGCGACTAG -> TAATCAGACGGCGACTAGC
TGAGGGTTGTTCGCGAAAA -> GAGGGTTGTTCGCGAAAAG
CTGCCGAGGCAGAGGCGGT -> TGCCGAGGCAGAGGCGGTC
AGAGGTCACAGTGCTGAGG -> GAGGTCACAGTGCTGAGGG
AGACTGGTGTTTCATGTCG -> GACTGGTGTTTCATGTCGT
TTTTATCCTAACGAACAAT -> TTTATCCTAACGAACAATT
TGGACCGCCGTGCGCCTCG -> GGACCGCCGTGCGCCTCGG
CCGCTAGATAGTGCAGGGC -> CGCTAGATAGTGCAGGGCT
ACCCCAATAATTTTCAAAA -> CCCCAATAATTTTCAAAAG
CCAATAATTTTCAAAAGTT -> CAATAATTTTCAAAAGTTA
TTACGTGGATATCACCTCA -> TACGTGGATATCACCTCAA
GCTTCACCGTCATAATTCA -> CTTCACCGTCATAATTCAT
CTCGTGCGAAGAGCATGAT -> TCGTGCGAAGAGCATGATA
ATCCTCAGAGAAAACCGGT -> TCCTCAGAGAAAACCGGTA
CAGTATGGCATCGAGCACC -> AGTATGGCATCGAGCACCT
ACGCTCGGTCCCGCAGATT -> CGCTCGGTCCCGCAGATTC
GTGCATTACGATGAAACCG -> TGCATTACGATGAAACCGC
CAGAATGCGAGTGGCTAGT -> AGAATGCGAGTGGCTAGTT
GTTCCTACCTTCTGAACTA -> TTCCTACCTTCTGAACTAT
ACCCTCACCAGCACGCTGG -> CCCTCACCAGCACGCTGGG
TCGCGTCCCTGCATAATTC -> CGCGTCCCTGCATAATTCA
ACTATCGTGCAAAGATCCA -> CTATCGTGCAAAGATCCAA
TTTAGCGCAGCTAACCTAC -> TTAGCGCAGCTAACCTACC
TCACCCCATCAGTATGGCA -> CACCCCATCAGTATGGCAT
TTCATATCTGTCGGGAGTT -> TCATATCTGTCGGGAGTTC
ACAGCGCTCCTACCCCAAT -> CAGCGCTCCTACCCCAATA
CGTATAGAGCAAGATTATG -> GTATAGAGCAAGATTATGA
GCAAACACGTATTTAATCA -> CAAACACGTATTTAATCAG
TTTAATCAGACGGCGACTA -> TTAATCAGACGGCGACTAG
TGTGTAGACACGATGCCTC -> GTGTAGACACGATGCCTCC
GTTGAATCACGGAATCTTA -> TTGAATCACGGAATCTTAA
GTTATTACGTGGATATCAC -> TTATTACGTGGATATCACC
GCTCTTATACACCGCTAGA -> CTCTTATACACCGCTAGAT
TCTTATACCCGATCGCCCG -> CTTATACCCGATCGCCCGC
GTGGGGTACGCTCGGTCCC -> TGGGGTACGCTCGGTCCCG
GGCGTGACATTGCTCAGGG -> GCGTGACATTGCTCAGGGC
CATGCGTGTCTAAAGGGCC -> ATGCGTGTCTAAAGGGCCT
GAACTATGACGGGGTGAAC -> AACTATGACGGGGTGAACC
CCTACCCCAATAATTTTCA -> CTACCCCAATAATTTTCAA
CCGCGTGGGGTACGCTCGG -> CGCGTGGGGTACGCTCGGT
TGAAACCGCGAGCGTCTCA -> GAAACCGCGAGCGTCTCAC
AATGCGAGTGGCTAGTTGC -> ATGCGAGTGGCTAGTTGCC
CACGATATCGCTTTGTTGA -> ACGATATCGCTTTGTTGAT
GGCTATCCATAATTCATAC -> GCTATCCATAATTCATACC
CCTGAACTATCGTGCAAAG -> CTGAACTATCGTGCAAAGA
TTCTGAATGCTGCGCATGC -> TCTGAATGCTGCGCATGCG
GTCCGTGTGCCCTAGCTTA -> TCCGTGTGCCCTAGCTTAT
TCGGATGGATACATCCGTG -> CGGATGGATACATCCGTGC
ACCGCACCTAGTTTGCCTG -> CCGCACCTAGTTTGCCTGA
TCGTCTTTGCGTAGTAAAT -> CGTCTTTGCGTAGTAAATT
GTTCCGCCCGTCTGTGCAT -> TTCCGCCCGTCTGTGCATT
ATAGAGCAAGATTATGACG -> TAGAGCAAGATTATGACGC
GCGTGACATTGCTCAGGGC -> CGTGACATTGCTCAGGGCA
TTCACCGTCATAATTCATA -> TCACCGTCATAATTCATAC
TGTGTTACCGTCCGCGATC -> GTGTTACCGTCCGCGATCC
ACCGAGGTAGGATTCGTCT -> CCGAGGTAGGATTCGTCTA
AATCTTAATTGTTATTTGT -> ATCTTAATTGTTATTTGTA
AGAGGCCGCTGAGCGTTGC -> GAGGCCGCTGAGCGTTGCT
CGCAACCGCACCTAGTTTG -> GCAACCGCACCTAGTTTGC
GTAGACACGATGCCTCCCG -> TAGACACGATGCCTCCCGT
CTGGGGAATTAGTAACGCG -> TGGGGAATTAGTAACGCGC
CAGACGGCGACTAGCTACA -> AGACGGCGACTAGCTACAT
TTGGTTGAGGAACCGTGAC -> TGGTTGAGGAACCGTGACC
GCGGCTATCCATAATTCAT -> CGGCTATCCATAATTCATA
AAGAGGCCGCTGAGCGTTG -> AGAGGCCGCTGAGCGTTGC
CCCTCAGAGCCAGAGCCTG -> CCTCAGAGCCAGAGCCTGG
ATTCATACCGCAAACGGTC -> TTCATACCGCAAACGGTCC
CGCCACTTTTCTGTACTCT -> GCCACTTTTCTGTACTCTA
ATGTCGCGTCCCTGCATAA -> TGTCGCGTCCCTGCATAAT
TTTCGGATGGATACATCCG -> TTCGGATGGATACATCCGT
TAATTCAAGATCTAACCCG -> AATTCAAGATCTAACCCGC
CTATCCATAATTCATACCG -> TATCCATAATTCATACCGC
ACCGCTAGATAGTGCAGGG -> CCGCTAGATAGTGCAGGGC
ACGATGCCTCCCGTGCCCA -> CGATGCCTCCCGTGCCCAC
GCCATTCGAGAAGTTCCCT -> CCATTCGAGAAGTTCCCTC
GGAGGGGTTCCGCCCGTCT -> GAGGGGTTCCGCCCGTCTG
ATCACAGCAGTATGGGCGC -> TCACAGCAGTATGGGCGCA
GCAGCTAACCTACCTTCTG -> CAGCTAACCTACCTTCTGA
AATTAGTAACGCGCCTCGT -> ATTAGTAACGCGCCTCGTC
GCTGCCGAGGCAGAGGCGG -> CTGCCGAGGCAGAGGCGGT
GTGCGCCTCGGTATTTCTG -> TGCGCCTCGGTATTTCTGA
TAATTGTTATTTGTAAGTG -> AATTGTTATTTGTAAGTGA
GCTCAGGGCACCTTCCCGT -> CTCAGGGCACCTTCCCGTC
GGCGCGTTTTGTAACACGT -> GCGCGTTTTGTAACACGTC
TCGGGAGTTCACCCCATCA -> CGGGAGTTCACCCCATCAG
GATACATCCGTGCCTTGGA -> ATACATCCGTGCCTTGGAA
TTCTTAGTACGACGCGTAT -> TCTTAGTACGACGCGTATC
CGTCTGTGCATTACGATGA -> GTCTGTGCATTACGATGAA
TCGAGAGTCTATCACCTAA -> CGAGAGTCTATCACCTAAG
ATATTAGTCCGTTGCCGAA -> TATTAGTCCGTTGCCGAAA
GCGCTTCACCGTCATAATT -> CGCTTCACCGTCATAATTC
CGAATGGCGCTTATAGAGG -> GAATGGCGCTTATAGAGGT
TACGCTCGGTCCCGCAGAT -> ACGCTCGGTCCCGCAGATT
ATGAGAATTGCACAATAAC -> TGAGAATTGCACAATAACA
TGGAAACCTTACGGATATT -> GGAAACCTTACGGATATTC
AAATCGTCTTTGCGTAGTA -> AATCGTCTTTGCGTAGTAA
AGCATGATAGAGGCACTGA -> GCATGATAGAGGCACTGAT
TGGCGTACTCGTGCAAGCT -> GGCGTACTCGTGCAAGCTG
ACGTATTTAATCAGACGGC -> CGTATTTAATCAGACGGCG
CGCATGCGTGTCTAAAGGG -> GCATGCGTGTCTAAAGGGC
TTGAGGTGCGTAATTCAAG -> TGAGGTGCGTAATTCAAGA
CTGACGGCGGAGGACTTAT -> TGACGGCGGAGGACTTATT
TGCTCAGGGCACCTTCCCG -> GCTCAGGGCACCTTCCCGT
CCGCGATCCCTTAGAAGTT -> CGCGATCCCTTAGAAGTTA
GCCTATACTACAGCGCTCC -> CCTATACTACAGCGCTCCT
TGAACTATCGTGCAAAGAT -> GAACTATCGTGCAAAGATC
TTTTCAAAAGTTATTACGT -> TTTCAAAAGTTATTACGTG
ATAATTCATACCGCAAACT -> TAATTCATACCGCAAACTT
TATCTGTCGGGAGTTCACC -> ATCTGTCGGGAGTTCACCC
CTCCGTACCATAAACGTGC -> TCCGTACCATAAACGTGCG
TGGGCACCGATGGTTCCTA -> GGGCACCGATGGTTCCTAC
GATAATCGTTGAATCACGG -> ATAATCGTTGAATCACGGA
TACGATGAAACCGCGAGCG -> ACGATGAAACCGCGAGCGT
AGGGCTGGGCAGATGTGAG -> GGGCTGGGCAGATGTGAGT
CCGGTAATAGACGTTATTA -> CGGTAATAGACGTTATTAG
TCGGTCCCGCAGATTCATC -> CGGTCCCGCAGATTCATCC
CAGCATGAATCCTCGTGCG -> AGCATGAATCCTCGTGCGA
GGTTCCGCCCGTCTGTGCA -> GTTCCGCCCGTCTGTGCAT
ACTAACGGAGGCATCCATT -> CTAACGGAGGCATCCATTC
TTGTTCGCGAAAAGAGGAT -> TGTTCGCGAAAAGAGGATG
TCACCAGCACGCTGGGGAA -> CACCAGCACGCTGGGGAAT
CGGCGACTAGCTACATTAT -> GGCGACTAGCTACATTATG
GTCTAAAGGGCCTCACGGT -> TCTAAAGGGCCTCACGGTA
CGGTAATAGACGTTATTAG -> GGTAATAGACGTTATTAGT
GAAGTTCCCTCAGAGCCAG -> AAGTTCCCTCAGAGCCAGA
TACCCCAATAATTTTCAAA -> ACCCCAATAATTTTCAAAA
CGGTATTTCTGACGGCGGA -> GGTATTTCTGACGGCGGAG
TGTAATGCTATTTTCGGAT -> GTAATGCTATTTTCGGATG
TCTGCTGCAGTCAGGTTAA -> CTGCTGCAGTCAGGTTAAG
TCTTAGTACGACGCGTATC -> CTTAGTACGACGCGTATCA
TCACCTCAATACTTGTGCA -> CACCTCAATACTTGTGCAA
AAACCGGTAATAGACGTTA -> AACCGGTAATAGACGTTAT
AGAGCCAGAGCCTGGCTGA -> GAGCCAGAGCCTGGCTGAG
CCCGTGCCCACGATATCGC -> CCGTGCCCACGATATCGCT
GTGTTTCATGTCGTCAGCA -> TGTTTCATGTCGTCAGCAG
AGCATGTCGTCATCATTGA -> GCATGTCGTCATCATTGAG
GTTTCCTTCATGTTAGCTA -> TTTCCTTCATGTTAGCTAC
GCATAATTCATACCGCAAA -> CATAATTCATACCGCAAAC
TCGTCATCATTGAGGTGCG -> CGTCATCATTGAGGTGCGT
TGCCATAACCCTCCTGTTC -> GCCATAACCCTCCTGTTCG
TATGGAGCGGCTATCCATA -> ATGGAGCGGCTATCCATAA
TCCAAGTTGGTTGAGGAAC -> CCAAGTTGGTTGAGGAACC
ATGTCGTCAGCAGAATGCG -> TGTCGTCAGCAGAATGCGA
GCACAATAACATTCTTATA -> CACAATAACATTCTTATAC
AAACGGTCCTGATCGTAAC -> AACGGTCCTGATCGTAACA
AGTACGACGCGTATCAATC -> GTACGACGCGTATCAATCC
TCGCCCGCGTGGGGTACGC -> CGCCCGCGTGGGGTACGCT
CAGCTGTGCCATAACCCTC -> AGCTGTGCCATAACCCTCC
GCGTATCAATCCTCAGGTC -> CGTATCAATCCTCAGGTCC
CAGCACGCTGGGGAATTAG -> AGCACGCTGGGGAATTAGT
TTCCAGGAGGCAGAGCCAT -> TCCAGGAGGCAGAGCCATT
AGTGCTGAGGGTTGTTCGC -> GTGCTGAGGGTTGTTCGCG
GTGCCATAACCCTCCTGTT -> TGCCATAACCCTCCTGTTC
GCAAACGGCGTGCTCCAAC -> CAAACGGCGTGCTCCAACC
GGTAAATCAATTCATATCT -> GTAAATCAATTCATATCTG
GCCAGAGCCTGGCTGAGAC -> CCAGAGCCTGGCTGAGACC
ATCTGAGTTGCGAATGGCG -> TCTGAGTTGCGAATGGCGC
GAGTGCGAACTGTGGGACA -> AGTGCGAACTGTGGGACAA
CGTCCGCGATCCCTTAGAA -> GTCCGCGATCCCTTAGAAG
GATATTCCCCTTACATAGT -> ATATTCCCCTTACATAGTC
CGTACCATAAACGTGCGGT -> GTACCATAAACGTGCGGTT
ATGTGAGTTGAGTGCGAAC -> TGTGAGTTGAGTGCGAACT
GCGAAGAGCATGATAGAGG -> CGAAGAGCATGATAGAGGC
AGTTGCTGTAATGCTATTT -> GTTGCTGTAATGCTATTTT
CGTCCCTGCATAATTCATA -> GTCCCTGCATAATTCATAC
AAACGGCGTGCTCCAACCG -> AACGGCGTGCTCCAACCGT
TAGTACGTCCGTGTGCCCT -> AGTACGTCCGTGTGCCCTA
GCAGTATGGGCGCAATATC -> CAGTATGGGCGCAATATCT
TGCAAAGATCCAATTGCCA -> GCAAAGATCCAATTGCCAG
TGGAGGGGTTCCGCCCGTC -> GGAGGGGTTCCGCCCGTCT
TAAACGTGCGGTTCTTAGT -> AAACGTGCGGTTCTTAGTA
ATCAGTATGGCATCGAGCA -> TCAGTATGGCATCGAGCAC
GCCGAACTAAATGACGGTT -> CCGAACTAAATGACGGTTT
ATTAGTAACGCGCCTCGTC -> TTAGTAACGCGCCTCGTCA
CGCTTTGTTGATAATCGTT -> GCTTTGTTGATAATCGTTG
TCCCGCAGATTCATCCGGC -> CCCGCAGATTCATCCGGCA
CGTACTGCATCTATCCTCA -> GTACTGCATCTATCCTCAG
TTGAGGAACCGTGACCATG -> TGAGGAACCGTGACCATGG
GCGTCTCACTAGAATGCGA -> CGTCTCACTAGAATGCGAG
AGCTACATTATGTATATTA -> GCTACATTATGTATATTAG
CATTTAAAAACTTCTGAAT -> ATTTAAAAACTTCTGAATG
AACTTGTCCACATTTAAAA -> ACTTGTCCACATTTAAAAA
ATTCCCCCCAACAATTCCA -> TTCCCCCCAACAATTCCAG
TGAACTATGTCGCGTCCCT -> GAACTATGTCGCGTCCCTG
TCCACATTTAAAAACTTCT -> CCACATTTAAAAACTTCTG
TGCATTACGATGAAACCGC -> GCATTACGATGAAACCGCG
GCGAATGGCGCTTATAGAG -> CGAATGGCGCTTATAGAGG
TGCGCTTCACCGTCATAAT -> GCGCTTCACCGTCATAATT
TTCTGCGTTCAATTATCAG -> TCTGCGTTCAATTATCAGT
AGTCCGTTGCCGAAATCGT -> GTCCGTTGCCGAAATCGTC
ACAATTTTGGCCGGTAATC -> CAATTTTGGCCGGTAATCA
CGTTATTAGTACGTCCGTG -> GTTATTAGTACGTCCGTGT
GCACGGGGAGCATAAGTTT -> CACGGGGAGCATAAGTTTC
GTGTAGACACGATGCCTCC -> TGTAGACACGATGCCTCCC
GTTAAACAAGGCAGACGCT -> TTAAACAAGGCAGACGCTT
CAGAGAAAACCGGTAATAG -> AGAGAAAACCGGTAATAGA
CCCTACCTTCTGAACTATG -> CCTACCTTCTGAACTATGC
TAACGAACAATTTTGGCCG -> AACGAACAATTTTGGCCGG
TAGTAACGCGCCTCGTCAT -> AGTAACGCGCCTCGTCATC
TCATGTCGTCAGCAGAATG -> CATGTCGTCAGCAGAATGC
GTCAGGTTAAGCTGCCGAG -> TCAGGTTAAGCTGCCGAGG
TGTCGGGAGTTCACCCCAT -> GTCGGGAGTTCACCCCATC
TTTGTAAGTGACGCCACTT -> TTGTAAGTGACGCCACTTT
ACTGGGCGTGACATTGCTC -> CTGGGCGTGACATTGCTCA
TGTATATTAGTCCGTTGCC -> GTATATTAGTCCGTTGCCG
AACGGGCACGGGGAGCATA -> ACGGGCACGGGGAGCATAA
AACGGCGTGCTCCAACCGT -> ACGGCGTGCTCCAACCGTG
TGCATAATTCATACCGCAA -> GCATAATTCATACCGCAAA
CTGTCCAAGTTGGTTGAGG -> TGTCCAAGTTGGTTGAGGA
CTTACATAGTCATGTGACC -> TTACATAGTCATGTGACCC
ATTCGTCTATGAGAATTGC -> TTCGTCTATGAGAATTGCA
GTGTCTAAAGGGCCTCACG -> TGTCTAAAGGGCCTCACGG
GTTGCCGAACTAAATGACG -> TTGCCGAACTAAATGACGG
GCTGCGCATGCGTGTCTAA -> CTGCGCATGCGTGTCTAAA
GCCCACGATATCGCTTTGT -> CCCACGATATCGCTTTGTT
AAAGATCCAATTGCCAGAG -> AAGATCCAATTGCCAGAGG
GAACTGTGGGACAATATAC -> AACTGTGGGACAATATACA
TCAATCCTCAGGTCCTTCT -> CAATCCTCAGGTCCTTCTG
ATATCCCAGAGCTTCTTCT -> TATCCCAGAGCTTCTTCTC
CAAAGATCCAATTGCCAGA -> AAAGATCCAATTGCCAGAG
GCCATAACCCTCCTGTTCG -> CCATAACCCTCCTGTTCGG
AGGTCCTTCTGCTGCAGTC -> GGTCCTTCTGCTGCAGTCA
CGTGCTCCAACCGTGGACC -> GTGCTCCAACCGTGGACCG
CCATAATTCATACCGCAAA -> CATAATTCATACCGCAAAC,CATAATTCATACCGCAAAC
TCCTGTTCGGCACAGCTGG -> CCTGTTCGGCACAGCTGGC
GGGCACGGGGAGCATAAGT -> GGCACGGGGAGCATAAGTT
AAGAGGATGGCGCGCCTAT -> AGAGGATGGCGCGCCTATA
AGGACTGTCCAAGTTGGTT -> GGACTGTCCAAGTTGGTTG
ACACGTCTGTGCGGAGTCT -> CACGTCTGTGCGGAGTCTA
CCTGGAGCGCTTTAAAACT -> CTGGAGCGCTTTAAAACTA
TTCACCCCATCAGTATGGC -> TCACCCCATCAGTATGGCA
GCTATCCATAATTCATACC -> CTATCCATAATTCATACCG
GAGGCGGTCGGGTGAGCAA -> AGGCGGTCGGGTGAGCAAA
TGAGGTGCGTAATTCAAGA -> GAGGTGCGTAATTCAAGAT
TTCATACCGCAAACGGTCC -> TCATACCGCAAACGGTCCT
ATGGCGTACTGCATCTATC -> TGGCGTACTGCATCTATCC
AGACGCTTCGTATAGAGCA -> GACGCTTCGTATAGAGCAA
GATATCACCTCAATACTTG -> ATATCACCTCAATACTTGT
CCGAGGTAGGATTCGTCTA -> CGAGGTAGGATTCGTCTAT
ACGAGTGACGTTTGATTAC -> CGAGTGACGTTTGATTACC
GGAATCTTAATTGTTATTT -> GAATCTTAATTGTTATTTG
TCCGTGTGCCCTAGCTTAT -> CCGTGTGCCCTAGCTTATA
AGGTAGGATTCGTCTATGA -> GGTAGGATTCGTCTATGAG
GACGCGTATCAATCCTCAG -> ACGCGTATCAATCCTCAGG
CAATTCATATCTGTCGGGA -> AATTCATATCTGTCGGGAG
GTTTCTGCGTTCAATTATC -> TTTCTGCGTTCAATTATCA
AGAGGATGGCGCGCCTATA -> GAGGATGGCGCGCCTATAC
GAGCAAGATTATGACGCGA -> AGCAAGATTATGACGCGAT
TGAGGAGGCGCGTTTTGTA -> GAGGAGGCGCGTTTTGTAA
TCCAACCGTGGACCGCCGT -> CCAACCGTGGACCGCCGTG
CCCGATCGCCCGCGTGGGG -> CCGATCGCCCGCGTGGGGT
TGGCGCTTATAGAGGTCAC -> GGCGCTTATAGAGGTCACA
GCATGAATCCTCGTGCGAA -> CATGAATCCTCGTGCGAAG
CGCAGCTAACCTACCTTCT -> GCAGCTAACCTACCTTCTG
CCGTGCGCCTCGGTATTTC -> CGTGCGCCTCGGTATTTCT
CCCTCACCAGCACGCTGGG -> CCTCACCAGCACGCTGGGG
AACTTCTGAATGCTGCGCA -> ACTTCTGAATGCTGCGCAT
ACGAACAATTTTGGCCGGT -> CGAACAATTTTGGCCGGTA
TGGATATCACCTCAATACT -> GGATATCACCTCAATACTT
CCCCCCAACAATTCCAGGA -> CCCCCAACAATTCCAGGAG
GATCTAACCCGCACATCGA -> ATCTAACCCGCACATCGAG
GAGCGCTTTAAAACTACAC -> AGCGCTTTAAAACTACACT
AAGAGCATGATAGAGGCAC -> AGAGCATGATAGAGGCACT
CAAGCTGTCTTCAACGGGC -> AAGCTGTCTTCAACGGGCA
GCCGGTAATCACAGCAGTA -> CCGGTAATCACAGCAGTAT
CCTTCTGAACTATGGAGCG -> CTTCTGAACTATGGAGCGG
ATTTCTGACGGCGGAGGAC -> TTTCTGACGGCGGAGGACT
GCGCGCCTATACTACAGCG -> CGCGCCTATACTACAGCGC
ACTTTTCTGTACTCTAACT -> CTTTTCTGTACTCTAACTT
CCTCCGTACCATAAACGTG -> CTCCGTACCATAAACGTGC
TTCGTATAGAGCAAGATTA -> TCGTATAGAGCAAGATTAT
AACCGCACCTAGTTTGCCT -> ACCGCACCTAGTTTGCCTG
AACCCTCCTGTTCGGCACA -> ACCCTCCTGTTCGGCACAG
CAGACGCTTCGTATAGAGC -> AGACGCTTCGTATAGAGCA
CCCCATCAGTATGGCATCG -> CCCATCAGTATGGCATCGA
TATCGTGCAAAGATCCAAT -> ATCGTGCAAAGATCCAATT
CCATGGCGTACTCGTGCAA -> CATGGCGTACTCGTGCAAG
AGGTTAAGCTGCCGAGGCA -> GGTTAAGCTGCCGAGGCAG
CTCGTGCAAGCTGTCTTCA -> TCGTGCAAGCTGTCTTCAA
TGCAGGGCTGGGCAGATGT -> GCAGGGCTGGGCAGATGTG
AGCTTCTTCTCGATGGAAT -> GCTTCTTCTCGATGGAATC
TAGAGCAAGATTATGACGC -> AGAGCAAGATTATGACGCG
AGGCGGTCGGGTGAGCAAA -> GGCGGTCGGGTGAGCAAAC
TACCTTCTGAACTATGTCG -> ACCTTCTGAACTATGTCGC
CGGCGGAGGACTTATTACA -> GGCGGAGGACTTATTACAA
GGAGCGGCTATCCATAATT -> GAGCGGCTATCCATAATTC
AAGCCAGACAGCTCTTATA -> AGCCAGACAGCTCTTATAC
AAGATCCAATTGCCAGAGG -> AGATCCAATTGCCAGAGGA
AACTGTGGGACAATATACA -> ACTGTGGGACAATATACAT
TGTGAGTTGAGTGCGAACT -> GTGAGTTGAGTGCGAACTG
AAGGAACGTTCCAGTACCG -> AGGAACGTTCCAGTACCGT
ATGACGGTTTGTACTAACG -> TGACGGTTTGTACTAACGG
ACGCTGGGGAATTAGTAAC -> CGCTGGGGAATTAGTAACG
GTTATTTGTAAGTGACGCC -> TTATTTGTAAGTGACGCCA
TCAAAAGTTATTACGTGGA -> CAAAAGTTATTACGTGGAT
TGATGGCGTACTGCATCTA -> GATGGCGTACTGCATCTAT
GATGCCTCCCGTGCCCACG -> ATGCCTCCCGTGCCCACGA
GAATTGCTCGAACGAGTGA -> AATTGCTCGAACGAGTGAC
GCTCGAACGAGTGACGTTT -> CTCGAACGAGTGACGTTTG
TACCTTCTGAACTATGACG -> ACCTTCTGAACTATGACGG
TAGTCATGTGACCCTCACC -> AGTCATGTGACCCTCACCA
AACCATAATTCATACCGCA -> ACCATAATTCATACCGCAA
GAGCCATTCGAGAAGTTCC -> AGCCATTCGAGAAGTTCCC
GACGGGGTGAACCATAATT -> ACGGGGTGAACCATAATTC
AACACGTCTGTGCGGAGTC -> ACACGTCTGTGCGGAGTCT
TGCTCGAACGAGTGACGTT -> GCTCGAACGAGTGACGTTT
CTTATAGCATGTCGTCATC -> TTATAGCATGTCGTCATCA
ATCCTCAGGTCCTTCTGCT -> TCCTCAGGTCCTTCTGCTG
CGGAGTCTAGACTGGTGTT -> GGAGTCTAGACTGGTGTTT
CGCTCGGTCCCGCAGATTC -> GCTCGGTCCCGCAGATTCA
TGGCGTACTGCATCTATCC -> GGCGTACTGCATCTATCCT
GTATATTAGTCCGTTGCCG -> TATATTAGTCCGTTGCCGA
CCGCACCTAGTTTGCCTGA -> CGCACCTAGTTTGCCTGAA
TCTGAATGCTGCGCATGCG -> CTGAATGCTGCGCATGCGT
TTAAGCTGCCGAGGCAGAG -> TAAGCTGCCGAGGCAGAGG
CCTACCTTCTGAACTATGC -> CTACCTTCTGAACTATGCG
CAGTCGATTCCCTACCTTC -> AGTCGATTCCCTACCTTCT
ATTACTGGGCGTGACATTG -> TTACTGGGCGTGACATTGC
CTGGGCAGATGTGAGTTGA -> TGGGCAGATGTGAGTTGAG
TTGCGAATGGCGCTTATAG -> TGCGAATGGCGCTTATAGA
GGGACAATATACATCAGCT -> GGACAATATACATCAGCTG
GAAGAGCATGATAGAGGCA -> AAGAGCATGATAGAGGCAC
TTGGCCGGTAATCACAGCA -> TGGCCGGTAATCACAGCAG
CATCGAGAGTCTATCACCT -> ATCGAGAGTCTATCACCTA
AGTAACGCGCCTCGTCATC -> GTAACGCGCCTCGTCATCC
CCGTGGACCGCCGTGCGCC -> CGTGGACCGCCGTGCGCCT
GTCGGGAGTTCACCCCATC -> TCGGGAGTTCACCCCATCA
CATCCGGCAAAGAGGCCGC -> ATCCGGCAAAGAGGCCGCT
CGCGTGGGGTACGCTCGGT -> GCGTGGGGTACGCTCGGTC
GGCGTGCTCCAACCGTGGA -> GCGTGCTCCAACCGTGGAC
ATTCATACCGCAAACTTGT -> TTCATACCGCAAACTTGTC
CTGAGTTGCGAATGGCGCT -> TGAGTTGCGAATGGCGCTT
CGTCAAGGAACGTTCCAGT -> GTCAAGGAACGTTCCAGTA
ACGATGAAACCGCGAGCGT -> CGATGAAACCGCGAGCGTC
TAATTTTATCCTAACGAAC -> AATTTTATCCTAACGAACA
AGAAAACCGGTAATAGACG -> GAAAACCGGTAATAGACGT
GTAAGTGACGCCACTTTTC -> TAAGTGACGCCACTTTTCT
TTGCCTACCTTCTGAACTA -> TGCCTACCTTCTGAACTAT
TCCTAACGAACAATTTTGG -> CCTAACGAACAATTTTGGC
ACCATAAACGTGCGGTTCT -> CCATAAACGTGCGGTTCTT
GCAGAATGCGAGTGGCTAG -> CAGAATGCGAGTGGCTAGT
GTGCGAACTGTGGGACAAT -> TGCGAACTGTGGGACAATA
CCAACCGTGGACCGCCGTG -> CAACCGTGGACCGCCGTGC
ACACGTATTTAATCAGACG -> CACGTATTTAATCAGACGG
CGATCGCCCGCGTGGGGTA -> GATCGCCCGCGTGGGGTAC
CTTGGAAATGAGGAGGCGC -> TTGGAAATGAGGAGGCGCG
ACCTTCCCGTCAAGGAACG -> CCTTCCCGTCAAGGAACGT
CATCCTACAGAGAATTGCT -> ATCCTACAGAGAATTGCTC
TCGAACGAGTGACGTTTGA -> CGAACGAGTGACGTTTGAT
TGAGCAAACGGCGTGCTCC -> GAGCAAACGGCGTGCTCCA
AGGGCACCTTCCCGTCAAG -> GGGCACCTTCCCGTCAAGG
GACGCGATTACTGGGCGTG -> ACGCGATTACTGGGCGTGA
ACGCGCCTCGTCATCCTAC -> CGCGCCTCGTCATCCTACA
GAATATCCCAGAGCTTCTT -> AATATCCCAGAGCTTCTTC
GTGAACCATAATTCATACC -> TGAACCATAATTCATACCG
TTTTGGCCGGTAATCACAG -> TTTGGCCGGTAATCACAGC
TCGGGTGAGCAAACGGCGT -> CGGGTGAGCAAACGGCGTG
GTGCGGTTCTTAGTACGAC -> TGCGGTTCTTAGTACGACG
TATTTCTGACGGCGGAGGA -> ATTTCTGACGGCGGAGGAC
GCAAGATTATGACGCGATT -> CAAGATTATGACGCGATTA
AATTGCACAATAACATTCT -> ATTGCACAATAACATTCTT
GTTACCGTCCGCGATCCCT -> TTACCGTCCGCGATCCCTT
AATTCAAGATCTAACCCGC -> ATTCAAGATCTAACCCGCA
ATTGCTCAGGGCACCTTCC -> TTGCTCAGGGCACCTTCCC
ACTGCATCTATCCTCAGAG -> CTGCATCTATCCTCAGAGA
ACGCGTATCAATCCTCAGG -> CGCGTATCAATCCTCAGGT
GCTGTAATTTTATCCTAAC -> CTGTAATTTTATCCTAACG
TCCCTACCTTCTGAACTAT -> CCCTACCTTCTGAACTATG
TAAATGACGGTTTGTACTA -> AAATGACGGTTTGTACTAA
GTTAAGCTGCCGAGGCAGA -> TTAAGCTGCCGAGGCAGAG
GCGCAATATCTCCAGCATG -> CGCAATATCTCCAGCATGA
TGGCTAGTTGCCTACCTTC -> GGCTAGTTGCCTACCTTCT
ATGGAATCGCTGTAATTTT -> TGGAATCGCTGTAATTTTA
CACGGTACCGAGGTAGGAT -> ACGGTACCGAGGTAGGATT
GTACGACGCGTATCAATCC -> TACGACGCGTATCAATCCT
ATCCTCGTGCGAAGAGCAT -> TCCTCGTGCGAAGAGCATG
TTTATGGCAAGGACCTGTG -> TTATGGCAAGGACCTGTGT
ACATTTAAAAACTTCTGAA -> CATTTAAAAACTTCTGAAT
GACGTTGGAAGCCAGACAG -> ACGTTGGAAGCCAGACAGC
CTATACTACAGCGCTCCTA -> TATACTACAGCGCTCCTAC
GTGTGCCCTAGCTTATAGC -> TGTGCCCTAGCTTATAGCA
ATGGCGTACTCGTGCAAGC -> TGGCGTACTCGTGCAAGCT
TGACGGGGTGAACCATAAT -> GACGGGGTGAACCATAATT
TGAGAATTGCACAATAACA -> GAGAATTGCACAATAACAT
TGACGGTTTGTACTAACGG -> GACGGTTTGTACTAACGGA
AAAGTTATTACGTGGATAT -> AAGTTATTACGTGGATATC
GAACCGTGACCATGGCGTA -> AACCGTGACCATGGCGTAC
AAAGGGCCTCACGGTACCG -> AAGGGCCTCACGGTACCGA
CTGCTGGAAACCTTACGGA -> TGCTGGAAACCTTACGGAT
TGCCTACCTTCTGAACTAT -> GCCTACCTTCTGAACTATG
GGCAAGGACCTGTGTTACC -> GCAAGGACCTGTGTTACCG
AGCGTTGCTTTAGCGCAGC -> GCGTTGCTTTAGCGCAGCT
GCGCCTATACTACAGCGCT -> CGCCTATACTACAGCGCTC
ACCTCAATACTTGTGCAAT -> CCTCAATACTTGTGCAATA
ACATCAGCTGTGCCATAAC -> CATCAGCTGTGCCATAACC
TATCTCCAGCATGAATCCT -> ATCTCCAGCATGAATCCTC
CGCGAGCGTCTCACTAGAA -> GCGAGCGTCTCACTAGAAT
CCAAGTTGGTTGAGGAACC -> CAAGTTGGTTGAGGAACCG
GAGTCTAGACTGGTGTTTC -> AGTCTAGACTGGTGTTTCA
TCTGTGCGGAGTCTAGACT -> CTGTGCGGAGTCTAGACTG
GTGCTCCAACCGTGGACCG -> TGCTCCAACCGTGGACCGC
TACGTCCGTGTGCCCTAGC -> ACGTCCGTGTGCCCTAGCT
GGTTCTTAGTACGACGCGT -> GTTCTTAGTACGACGCGTA
TACCGCAAACACGTATTTA -> ACCGCAAACACGTATTTAA
TCTGTACTCTAACTTGGGC -> CTGTACTCTAACTTGGGCA
GTCGATTCCCTACCTTCTG -> TCGATTCCCTACCTTCTGA
TGCGCATGCGTGTCTAAAG -> GCGCATGCGTGTCTAAAGG
GTTGGAAGCCAGACAGCTC -> TTGGAAGCCAGACAGCTCT
AATGAGGAGGCGCGTTTTG -> ATGAGGAGGCGCGTTTTGT
GAGGCAGAGCCATTCGAGA -> AGGCAGAGCCATTCGAGAA
CCGGTAATCACAGCAGTAT -> CGGTAATCACAGCAGTATG
AACCCGCACATCGAGAGTC -> ACCCGCACATCGAGAGTCT
ACGTGGATATCACCTCAAT -> CGTGGATATCACCTCAATA
TTTGCCTGAACTATCGTGC -> TTGCCTGAACTATCGTGCA
ATACTTGTGCAATACTCTT -> TACTTGTGCAATACTCTTG
GTTGTTCGCGAAAAGAGGA -> TTGTTCGCGAAAAGAGGAT
TTGAGTGCGAACTGTGGGA -> TGAGTGCGAACTGTGGGAC
TACCATAAACGTGCGGTTC -> ACCATAAACGTGCGGTTCT
ACCTGGAGCGCTTTAAAAC -> CCTGGAGCGCTTTAAAACT
ATGGCATCGAGCACCTGGA -> TGGCATCGAGCACCTGGAG
AGAGCAAGATTATGACGCG -> GAGCAAGATTATGACGCGA
TGGCTCGCAACCGCACCTA -> GGCTCGCAACCGCACCTAG
TTGGGCACCGATGGTTCCT -> TGGGCACCGATGGTTCCTA
AGTTTGCCTGAACTATCGT -> GTTTGCCTGAACTATCGTG
CGTGCGAAGAGCATGATAG -> GTGCGAAGAGCATGATAGA
TGCGAATGGCGCTTATAGA -> GCGAATGGCGCTTATAGAG
TCTATGAGAATTGCACAAT -> CTATGAGAATTGCACAATA
ACATCTGAGTTGCGAATGG -> CATCTGAGTTGCGAATGGC
CCTAAGACGTTGGAAGCCA -> CTAAGACGTTGGAAGCCAG
GGTACGCTCGGTCCCGCAG -> GTACGCTCGGTCCCGCAGA
ATGCCTCCCGTGCCCACGA -> TGCCTCCCGTGCCCACGAT
ACATTCTTATACCCGATCG -> CATTCTTATACCCGATCGC
CTGTACTCTAACTTGGGCA -> TGTACTCTAACTTGGGCAC
GCAAACGGTCCTGATCGTA -> CAAACGGTCCTGATCGTAA
CTTCTGCTGCAGTCAGGTT -> TTCTGCTGCAGTCAGGTTA
GGTAGGATTCGTCTATGAG -> GTAGGATTCGTCTATGAGA
TTCCCTCAGAGCCAGAGCC -> TCCCTCAGAGCCAGAGCCT
AATCGTTGAATCACGGAAT -> ATCGTTGAATCACGGAATC
ACCGTCCGCGATCCCTTAG -> CCGTCCGCGATCCCTTAGA
TCAATTATCAGTCGATTCC -> CAATTATCAGTCGATTCCC
AAAAGAGGATGGCGCGCCT -> AAAGAGGATGGCGCGCCTA
TAGCTACATTATGTATATT -> AGCTACATTATGTATATTA
GCTTATAGCATGTCGTCAT -> CTTATAGCATGTCGTCATC
CGGGGTGAACCATAATTCA -> GGGGTGAACCATAATTCAT
TTGAATCACGGAATCTTAA -> TGAATCACGGAATCTTAAT
ATCGAGAGTCTATCACCTA -> TCGAGAGTCTATCACCTAA
TGTGGGACAATATACATCA -> GTGGGACAATATACATCAG
CACTAGAATGCGAGTTGCC -> ACTAGAATGCGAGTTGCCG
CTACCCCAATAATTTTCAA -> TACCCCAATAATTTTCAAA
GGCGCAATATCTCCAGCAT -> GCGCAATATCTCCAGCATG
GATCCAATTGCCAGAGGAC -> ATCCAATTGCCAGAGGACT
CTCGGTATTTCTGACGGCG -> TCGGTATTTCTGACGGCGG
TGCTGCGCATGCGTGTCTA -> GCTGCGCATGCGTGTCTAA
GGTGCGTAATTCAAGATCT -> GTGCGTAATTCAAGATCTA
GCACATCGAGAGTCTATCA -> CACATCGAGAGTCTATCAC
TGCGCCTCGGTATTTCTGA -> GCGCCTCGGTATTTCTGAC
TGAACCATAATTCATACCG -> GAACCATAATTCATACCGC
AGCCAGACAGCTCTTATAC -> GCCAGACAGCTCTTATACA
CTCAGAGCCAGAGCCTGGC -> TCAGAGCCAGAGCCTGGCT
TCTCCAGCATGAATCCTCG -> CTCCAGCATGAATCCTCGT
CCCAACAATTCCAGGAGGC -> CCAACAATTCCAGGAGGCA
