AAAAACTCGCC -> AAAACTCGCCT
AAAACCTGGGC -> AAACCTGGGCA
AAAACGATAGT -> AAACGATAGTA
AAAACGTAAAT -> AAACGTAAATC
AAAACTCGCCT -> AAACTCGCCTA
AAAAGGTCGCG -> AAAGGTCGCGG
AAAAGTCACCG -> AAAGTCACCGC
AAAAGTCGAAT -> AAAGTCGAATA
AAAATACTTAC -> AAATACTTACT
AAAATCAATCT -> AAATCAATCTG
AAAATGAACTC -> AAATGAACTCT
AAACATGATGT -> AACATGATGTT
AAACATTCAAC -> AACATTCAACA
AAACCCGGTCC -> AACCCGGTCCA
AAACCTGGGCA -> AACCTGGGCAT
AAACGATAGTA -> AACGATAGTAA
AAACGTAAATC -> AACGTAAATCG
AAACTCACGAA -> AACTCACGAAC
AAACTCGCCTA -> AACTCGCCTAG
AAAGAAATGTA -> AAGAAATGTAG
AAAGCCGGCAG -> AAGCCGGCAGG
AAAGCTGGTCT -> AAGCTGGTCTT
AAAGGCTAATG -> AAGGCTAATGG
AAAGGTAATCC -> AAGGTAATCCA
AAAGGTACGAG -> AAGGTACGAGG
AAAGGTCGCGG -> AAGGTCGCGGA
AAAGGTGTGAT -> AAGGTGTGATG
AAAGTCACCGC -> AAGTCACCGCG
AAAGTCCCCAA -> AAGTCCCCAAT
AAAGTCGAATA -> AAGTCGAATAG
AAATACCTTAG -> AATACCTTAGT
AAATACTTACT -> AATACTTACTC
AAATCAATCTG -> AATCAATCTGT
AAATCCAACGT -> AATCCAACGTG
AAATCGCACAG -> AATCGCACAGG
AAATGAACTCT -> AATGAACTCTG
AAATGCCGTCG -> AATGCCGTCGA
AAATGTAGGTG -> AATGTAGGTGA
AAATGTCTGTA -> AATGTCTGTAA
AAATTCGATTC -> AATTCGATTCT
AACAACCAGGG -> ACAACCAGGGG
AACACCACCAA -> ACACCACCAAT
AACAGAACCCG -> ACAGAACCCGG
AACATAACGAT -> ACATAACGATG
AACATCTGTCT -> ACATCTGTCTG
AACATGATGTT -> ACATGATGTTT
AACATTCAACA -> ACATTCAACAA
AACCAACTCCT -> ACCAACTCCTT
AACCAGGGGTC -> ACCAGGGGTCA
AACCCCGACGC -> ACCCCGACGCA
AACCCGAAAGG -> ACCCGAAAGGC
AACCCGGCCCA -> ACCCGGCCCAG
AACCCGGTCCA -> ACCCGGTCCAC
AACCTGGGCAT -> ACCTGGGCATG
AACGAAGCTAG -> ACGAAGCTAGA
AACGATAGTAA -> ACGATAGTAAT
AACGATCAGAG -> ACGATCAGAGA
AACGATGACAT -> ACGATGACATG
AACGCAGCACG -> ACGCAGCACGT
AACGTAAATCG -> ACGTAAATCGC
AACGTACATAG -> ACGTACATAGG
AACGTCGTAAC -> ACGTCGTAACT
AACGTGGAAGT -> ACGTGGAAGTG
AACGTTCTGCA -> ACGTTCTGCAT
AACTACCCGTA -> ACTACCCGTAG
AACTACCGTCA -> ACTACCGTCAT
AACTATATTCG -> ACTATATTCGA
AACTCACGAAC -> ACTCACGAACT
AACTCCTTGGT -> ACTCCTTGGTG
AACTCGACTAC -> ACTCGACTACG
AACTCGCCTAG -> ACTCGCCTAGC
AACTCTGCCGG -> ACTCTGCCGGT
AACTGCGTTCC -> ACTGCGTTCCG
AAGAAATGTAG -> AGAAATGTAGG
AAGAAATTCGA -> AGAAATTCGAT
AAGACAAACTC -> AGACAAACTCA
AAGAGCTCCGA -> AGAGCTCCGAG
AAGAGGCCTGC -> AGAGGCCTGCG
AAGATCTTCTC -> AGATCTTCTCA
AAGCACCGCAT -> AGCACCGCATT
AAGCATTCGAA -> AGCATTCGAAA
AAGCCATCATC -> AGCCATCATCA
AAGCCGGCAGG -> AGCCGGCAGGG
AAGCCTCCACC -> AGCCTCCACCA
AAGCTAGAGAT -> AGCTAGAGATT
AAGCTCGTAGC -> AGCTCGTAGCT
AAGCTGGTCTT -> AGCTGGTCTTC
AAGGATACAAT -> AGGATACAATG
AAGGCTAATGG -> AGGCTAATGGA
AAGGTAATCCA -> AGGTAATCCAA
AAGGTACGAGG -> AGGTACGAGGT
AAGGTCGCGGA -> AGGTCGCGGAC
AAGGTCTAACA -> AGGTCTAACAG
AAGGTGTGATG -> AGGTGTGATGG
AAGTAAAATGA -> AGTAAAATGAA
AAGTCACCGCG -> AGTCACCGCGC
AAGTCCCCAAT -> AGTCCCCAATT
AAGTCGAATAG -> AGTCGAATAGG
AAGTCTTTCCA -> AGTCTTTCCAA
AAGTGAGGTAT -> AGTGAGGTATA
AAGTGGATCCC -> AGTGGATCCCC
AAGTGGGGGTT -> AGTGGGGGTTC
AAGTGTCGGGC -> AGTGTCGGGCG
AAGTTCGGGTG -> AGTTCGGGTGC
AATACACTTCG -> ATACACTTCGT
AATACCTTAGT -> ATACCTTAGTG
AATACGCGCAA -> ATACGCGCAAC
AATACTTACTC -> ATACTTACTCT
AATAGGCAGCC -> ATAGGCAGCCA
AATAGTGAAGT -> ATAGTGAAGTA
AATATAGTGTA -> ATATAGTGTAC
AATCAATCTGT -> ATCAATCTGTG
AATCATAATGT -> ATCATAATGTC
AATCCAACGTG -> ATCCAACGTGG
AATCCAAGTTC -> ATCCAAGTTCG
AATCGACTAAC -> ATCGACTAACT
AATCGACTGAC -> ATCGACTGACT
AATCGCACAGG -> ATCGCACAGGG
AATCGCCATAT -> ATCGCCATATA
AATCGGGTCCA -> ATCGGGTCCAG
AATCTGCCTTG -> ATCTGCCTTGT
AATCTGTGCAC -> ATCTGTGCACC
AATGAACTCTG -> ATGAACTCTGC
AATGCCATCAC -> ATGCCATCACT
AATGCCGTCGA -> ATGCCGTCGAA
AATGCGGGCTG -> ATGCGGGCTGG
AATGGAGGCTG -> ATGGAGGCTGG
AATGTAGACTT -> ATGTAGACTTA
AATGTAGGTGA -> ATGTAGGTGAC
AATGTCAGTTG -> ATGTCAGTTGC
AATGTCTGTAA -> ATGTCTGTAAG
AATGTGTTGGG -> ATGTGTTGGGT
AATGTTATTTT -> ATGTTATTTTA
AATTACGTACA -> ATTACGTACAA
AATTAGCAGGC -> ATTAGCAGGCT
AATTCGATTCT -> ATTCGATTCTG
AATTGATTCCG -> ATTGATTCCGA
AATTTCCGTTA -> ATTTCCGTTAG
ACAAACTCACG -> CAAACTCACGA
ACAAATGCCGT -> CAAATGCCGTC
ACAACATAACG -> CAACATAACGA
ACAACCAGGGG -> CAACCAGGGGT
ACAACGTCGTA -> CAACGTCGTAA
ACAATCGGGTC -> CAATCGGGTCC
ACAATGCCATC -> CAATGCCATCA
ACACAGACGCC -> CACAGACGCCT
ACACCACCAAT -> CACCACCAATC
ACACCCAAGCT -> CACCCAAGCTC
ACACGTGGTAC -> CACGTGGTACG
ACACGTGTTAA -> CACGTGTTAAT
ACACTTCGTGC -> CACTTCGTGCC
ACAGAACCCGG -> CAGAACCCGGC
ACAGACGCCTG -> CAGACGCCTGC
ACAGATCCACG -> CAGATCCACGG
ACAGCAACGTT -> CAGCAACGTTC
ACAGCATTACG -> CAGCATTACGA
ACAGCCGTGAC -> CAGCCGTGACT
ACAGGGATCAA -> CAGGGATCAAG
ACAGTCACGGT -> CAGTCACGGTA
ACATAAAACGA -> CATAAAACGAT
ACATAAAAGTC -> CATAAAAGTCG
ACATAACGATG -> CATAACGATGA
ACATAAGAGGC -> CATAAGAGGCC
ACATAAGTGAG -> CATAAGTGAGG
ACATAGGAGCG -> CATAGGAGCGG
ACATCACCTTA -> CATCACCTTAG
ACATCTAAGAA -> CATCTAAGAAA
ACATCTCCAAG -> CATCTCCAAGC
ACATCTGTCTG -> CATCTGTCTGC
ACATGATGTTT -> CATGATGTTTG
ACATGGTTCGG -> CATGGTTCGGT
ACATTCAACAA -> CATTCAACAAC
ACATTCCTGTG -> CATTCCTGTGA
ACATTGGCACC -> CATTGGCACCT
ACATTTTCGCC -> CATTTTCGCCG
ACCAACTCCTT -> CCAACTCCTTG
ACCAATCGCCA -> CCAATCGCCAT
ACCACAAATGC -> CCACAAATGCC
ACCACCAATCG -> CCACCAATCGC
ACCACCATTAT -> CCACCATTATT
ACCACTATACG -> CCACTATACGG
ACCACTGTCTC -> CCACTGTCTCC
ACCAGGCACCG -> CCAGGCACCGG
ACCAGGGGTCA -> CCAGGGGTCAT
ACCATGGGCAT -> CCATGGGCATT
ACCATTATTAT -> CCATTATTATA
ACCCAAGCTCG -> CCCAAGCTCGT
ACCCATTCCTC -> CCCATTCCTCT
ACCCCGACGCA -> CCCCGACGCAT
ACCCCGTAACC -> CCCCGTAACCA
ACCCCTCGGCG -> CCCCTCGGCGG
ACCCGAAAGGC -> CCCGAAAGGCT
ACCCGGCCCAG -> CCCGGCCCAGC
ACCCGGTCCAC -> CCCGGTCCACG
ACCCGTAGTCG -> CCCGTAGTCGA
ACCGAGCGGAG -> CCGAGCGGAGA
ACCGCATTACG -> CCGCATTACGG
ACCGCGCGCCC -> CCGCGCGCCCC
ACCGCGGTGCG -> CCGCGGTGCGA
ACCGGGACATC -> CCGGGACATCA
ACCGGTAGGGC -> CCGGTAGGGCG
ACCGGTCGGAA -> CCGGTCGGAAA
ACCGTCATCAC -> CCGTCATCACC
ACCTGCTGTTG -> CCTGCTGTTGT
ACCTGGGCATG -> CCTGGGCATGA
ACCTTAAAGCC -> CCTTAAAGCCG
ACCTTAGGGGA -> CCTTAGGGGAA
ACCTTAGTGAT -> CCTTAGTGATT
ACGAACGCAGC -> CGAACGCAGCA
ACGAACTATAT -> CGAACTATATT
ACGAAGCTAGA -> CGAAGCTAGAG
ACGAGAATAGT -> CGAGAATAGTG
ACGAGCCTCGT -> CGAGCCTCGTT
ACGAGGTAAGC -> CGAGGTAAGCA
ACGAGGTGTCG -> CGAGGTGTCGT
ACGATAGTAAT -> CGATAGTAATA
ACGATCAGAGA -> CGATCAGAGAG
ACGATGACATG -> CGATGACATGG
ACGCAGCACGT -> CGCAGCACGTG
ACGCAGTACCA -> CGCAGTACCAG
ACGCATTATTG -> CGCATTATTGT
ACGCCACACCC -> CGCCACACCCA
ACGCCCCGAGA -> CGCCCCGAGAA
ACGCCGGTGTG -> CGCCGGTGTGA
ACGCCTGCTTA -> CGCCTGCTTAA
ACGCGCAACGA -> CGCGCAACGAA
ACGGCATGTCC -> CGGCATGTCCT
ACGGGTCATCA -> CGGGTCATCAG
ACGGTACCTTA -> CGGTACCTTAA
ACGGTAGGCCA -> CGGTAGGCCAG
ACGGTCCCCAC -> CGGTCCCCACA
ACGTAAATCGC -> CGTAAATCGCA
ACGTACAACGT -> CGTACAACGTC
ACGTACATAGG -> CGTACATAGGA
ACGTCGTAACT -> CGTCGTAACTA
ACGTCTGGATG -> CGTCTGGATGC
ACGTGACGCAG -> CGTGACGCAGT
ACGTGGAAGTG -> CGTGGAAGTGT
ACGTGGCAAGT -> CGTGGCAAGTG
ACGTGGTACGT -> CGTGGTACGTG
ACGTGTTAATC -> CGTGTTAATCG
ACGTTAGACAG -> CGTTAGACAGA
ACGTTCTGCAT -> CGTTCTGCATA
ACTAAAACGTA -> CTAAAACGTAA
ACTAAAAGTCA -> CTAAAAGTCAC
ACTAACTACCG -> CTAACTACCGT
ACTACCCGTAG -> CTACCCGTAGT
ACTACCGTCAT -> CTACCGTCATC
ACTACGCCGGT -> CTACGCCGGTG
ACTAGGGAGGT -> CTAGGGAGGTA
ACTATACGGTC -> CTATACGGTCC
ACTATATTCGA -> CTATATTCGAC
ACTCACGAACT -> CTCACGAACTA
ACTCCTTGGTG -> CTCCTTGGTGA
ACTCGACTACG -> CTCGACTACGC
ACTCGAGTAAT -> CTCGAGTAATC
ACTCGCCTAGC -> CTCGCCTAGCC
ACTCGTCGACA -> CTCGTCGACAT
ACTCTAAGCCT -> CTCTAAGCCTC
ACTCTCAAATC -> CTCTCAAATCC
ACTCTGCCGGT -> CTCTGCCGGTA
ACTCTTCAGAT -> CTCTTCAGATC
ACTGAAAAACT -> CTGAAAAACTC
ACTGACTAAAA -> CTGACTAAAAC
ACTGATTATGT -> CTGATTATGTA
ACTGCGTTCCG -> CTGCGTTCCGC
ACTGGATTTAC -> CTGGATTTACG
ACTGGTAAGCC -> CTGGTAAGCCA
ACTGTCTCCTT -> CTGTCTCCTTG
ACTTAACTCGA -> CTTAACTCGAC
ACTTACTCTCA -> CTTACTCTCAA
ACTTCCCATGA -> CTTCCCATGAA
ACTTCGACTAG -> CTTCGACTAGG
ACTTCGTGCCT -> CTTCGTGCCTC
ACTTGTACATT -> CTTGTACATTC
AGAAAGCTGGT -> GAAAGCTGGTC
AGAAAGGTACG -> GAAAGGTACGA
AGAAATGTAGG -> GAAATGTAGGT
AGAAATTCGAT -> GAAATTCGATT
AGAACCCGGCC -> GAACCCGGCCC
AGAACGTACAT -> GAACGTACATA
AGAATAGTGAA -> GAATAGTGAAG
AGAATCGACTA -> GAATCGACTAA
AGAATTAGCAG -> GAATTAGCAGG
AGAATTGATTC -> GAATTGATTCC
AGACAAACTCA -> GACAAACTCAC
AGACAGATCCA -> GACAGATCCAC
AGACCGCGGTG -> GACCGCGGTGC
AGACGCCTGCT -> GACGCCTGCTT
AGACTGAAAAA -> GACTGAAAAAC
AGACTTAACTC -> GACTTAACTCG
AGAGAGGAGGC -> GAGAGGAGGCC
AGAGATTGTGC -> GAGATTGTGCT
AGAGCTCCGAG -> GAGCTCCGAGT
AGAGGAGGCCC -> GAGGAGGCCCG
AGAGGCCTGCG -> GAGGCCTGCGT
AGAGGTGGACA -> GAGGTGGACAG
AGATCCACGGT -> GATCCACGGTA
AGATCCGAGTC -> GATCCGAGTCT
AGATCTTCTCA -> GATCTTCTCAT
AGATTGTGCTA -> GATTGTGCTAC
AGCAACGTTCT -> GCAACGTTCTG
AGCACCGCATT -> GCACCGCATTA
AGCACGTGGCA -> GCACGTGGCAA
AGCAGGCTGGG -> GCAGGCTGGGT
AGCATTACGAG -> GCATTACGAGC
AGCATTCGAAA -> GCATTCGAAAA
AGCCAAGAGCT -> GCCAAGAGCTC
AGCCACCATGG -> GCCACCATGGG
AGCCATCATCA -> GCCATCATCAT
AGCCATGCACA -> GCCATGCACAT
AGCCGGCAGGG -> GCCGGCAGGGG
AGCCGTGACTC -> GCCGTGACTCG
AGCCTCCACCA -> GCCTCCACCAC
AGCCTCGTTGT -> GCCTCGTTGTG
AGCCTTACCGA -> GCCTTACCGAG
AGCGGAGAGGT -> GCGGAGAGGTG
AGCGGGATATG -> GCGGGATATGC
AGCTAGAGATT -> GCTAGAGATTG
AGCTCAGGGCA -> GCTCAGGGCAA
AGCTCCCATCG -> GCTCCCATCGG
AGCTCCGAGTA -> GCTCCGAGTAA
AGCTCGTAGCT -> GCTCGTAGCTC
AGCTGGTCTTC -> GCTGGTCTTCT
AGGACGAACGC -> GGACGAACGCA
AGGAGCGGGAT -> GGAGCGGGATA
AGGAGGCCCGC -> GGAGGCCCGCG
AGGATACAATG -> GGATACAATGC
AGGCACCGGGA -> GGCACCGGGAC
AGGCAGCCACC -> GGCAGCCACCA
AGGCCAATGCG -> GGCCAATGCGG
AGGCCAGACCG -> GGCCAGACCGC
AGGCCCGCGCA -> GGCCCGCGCAA
AGGCCTGCGTA -> GGCCTGCGTAA
AGGCTAATGGA -> GGCTAATGGAG
AGGCTGGATGT -> GGCTGGATGTA
AGGCTGGGTAA -> GGCTGGGTAAT
AGGGAGGTACG -> GGGAGGTACGA
AGGGATCAAGG -> GGGATCAAGGA
AGGGCAAAATA -> GGGCAAAATAC
AGGGCGTTTAC -> GGGCGTTTACA
AGGGGAACACC -> GGGGAACACCA
AGGGGGTTGTC -> GGGGGTTGTCG
AGGGGTCATCT -> GGGGTCATCTC
AGGGTGAACCC -> GGGTGAACCCG
AGGTAAGCATT -> GGTAAGCATTC
AGGTAATCCAA -> GGTAATCCAAG
AGGTACGAGAA -> GGTACGAGAAT
AGGTACGAGGT -> GGTACGAGGTA
AGGTATACTCG -> GGTATACTCGA
AGGTCGCGGAC -> GGTCGCGGACC
AGGTCTAACAG -> GGTCTAACAGA
AGGTGACAGTC -> GGTGACAGTCA
AGGTGGACAGC -> GGTGGACAGCC
AGGTGTCGTTC -> GGTGTCGTTCC
AGGTGTGATGG -> GGTGTGATGGG
AGTAAAACCTG -> GTAAAACCTGG
AGTAAAATGAA -> GTAAAATGAAC
AGTAAACATTC -> GTAAACATTCA
AGTAATATAGT -> GTAATATAGTG
AGTAATCTGCC -> GTAATCTGCCT
AGTACATTTTC -> GTACATTTTCG
AGTACCAGGCA -> GTACCAGGCAC
AGTATATCAGG -> GTATATCAGGG
AGTATCGGACT -> GTATCGGACTG
AGTCACCGCGC -> GTCACCGCGCG
AGTCACGGTAG -> GTCACGGTAGG
AGTCATACTGG -> GTCATACTGGT
AGTCCCCAATT -> GTCCCCAATTT
AGTCGAATAGG -> GTCGAATAGGC
AGTCGACCACT -> GTCGACCACTA
AGTCGCTTTTT -> GTCGCTTTTTT
AGTCTACAACA -> GTCTACAACAT
AGTCTTTCCAA -> GTCTTTCCAAC
AGTGAAGTAAA -> GTGAAGTAAAA
AGTGAGGTATA -> GTGAGGTATAC
AGTGATTAGTA -> GTGATTAGTAT
AGTGGATCCCC -> GTGGATCCCCC
AGTGGGGGTTC -> GTGGGGGTTCA
AGTGTACAATC -> GTGTACAATCG
AGTGTACATCT -> GTGTACATCTA
AGTGTCGGGCG -> GTGTCGGGCGC
AGTTCGGGTGC -> GTTCGGGTGCT
AGTTGCGGGTG -> GTTGCGGGTGT
ATAAAACGATA -> TAAAACGATAG
ATAAAAGTCGA -> TAAAAGTCGAA
ATAACGATGAC -> TAACGATGACA
ATAAGAGGCCT -> TAAGAGGCCTG
ATAAGTGAGGT -> TAAGTGAGGTA
ATAATGTCAGT -> TAATGTCAGTT
ATACAATGCCA -> TACAATGCCAT
ATACACTTCGT -> TACACTTCGTG
ATACAGCATTA -> TACAGCATTAC
ATACATTGGCA -> TACATTGGCAC
ATACCACAAAT -> TACCACAAATG
ATACCGGTAGG -> TACCGGTAGGG
ATACCTTAGTG -> TACCTTAGTGA
ATACGCGCAAC -> TACGCGCAACG
ATACGGTCCCC -> TACGGTCCCCA
ATACTCGAGTA -> TACTCGAGTAA
ATACTGGTAAG -> TACTGGTAAGC
ATACTTACTCT -> TACTTACTCTC
ATAGGAGCGGG -> TAGGAGCGGGA
ATAGGCAGCCA -> TAGGCAGCCAC
ATAGTAATATA -> TAGTAATATAG
ATAGTGAAGTA -> TAGTGAAGTAA
ATAGTGTACAA -> TAGTGTACAAT
ATATACCGGTA -> TATACCGGTAG
ATATAGTGTAC -> TATAGTGTACA
ATATATCGAAG -> TATATCGAAGT
ATATCAGGGTG -> TATCAGGGTGA
ATATCGAAGTC -> TATCGAAGTCT
ATATGCAACCC -> TATGCAACCCC
ATATTCGACTG -> TATTCGACTGG
ATATTGCTTTT -> TATTGCTTTTG
ATCAAGGATAC -> TCAAGGATACA
ATCAATCTGTG -> TCAATCTGTGC
ATCACCCATTC -> TCACCCATTCC
ATCACCTTAGG -> TCACCTTAGGG
ATCACTAAAAG -> TCACTAAAAGT
ATCAGAGAGGA -> TCAGAGAGGAG
ATCAGGACGAA -> TCAGGACGAAC
ATCAGGGTGAA -> TCAGGGTGAAC
ATCAGTACATT -> TCAGTACATTT
ATCATAATGTC -> TCATAATGTCA
ATCATCATTTC -> TCATCATTTCA
ATCATTTCATC -> TCATTTCATCG
ATCCAACGTGG -> TCCAACGTGGA
ATCCAAGTTCG -> TCCAAGTTCGG
ATCCACGCCCC -> TCCACGCCCCG
ATCCACGGTAC -> TCCACGGTACC
ATCCCCCGTCC -> TCCCCCGTCCC
ATCCGAGTCTA -> TCCGAGTCTAC
ATCGAAGTCTT -> TCGAAGTCTTT
ATCGACTAACT -> TCGACTAACTA
ATCGACTGACT -> TCGACTGACTA
ATCGCACAGGG -> TCGCACAGGGA
ATCGCCATATA -> TCGCCATATAC
ATCGGACTGAT -> TCGGACTGATT
ATCGGCATTCA -> TCGGCATTCAC
ATCGGGTCCAG -> TCGGGTCCAGA
ATCGTGCTCCG -> TCGTGCTCCGG
ATCTAACGATC -> TCTAACGATCA
ATCTAAGAAAT -> TCTAAGAAATT
ATCTCCAAGCA -> TCTCCAAGCAC
ATCTCTTTTCT -> TCTCTTTTCTA
ATCTGCCTTGT -> TCTGCCTTGTA
ATCTGTCTGCT -> TCTGTCTGCTC
ATCTGTGCACC -> TCTGTGCACCA
ATCTTAGAATC -> TCTTAGAATCG
ATCTTCGGGAG -> TCTTCGGGAGT
ATCTTCTCATC -> TCTTCTCATCT
ATGAAAGGTAA -> TGAAAGGTAAT
ATGAAAGGTGT -> TGAAAGGTGTG
ATGAACTCTGC -> TGAACTCTGCC
ATGAAGTGGAT -> TGAAGTGGATC
ATGACATGGTT -> TGACATGGTTC
ATGATGTTTGC -> TGATGTTTGCT
ATGCAACCCCG -> TGCAACCCCGA
ATGCAATCATA -> TGCAATCATAA
ATGCACATAAA -> TGCACATAAAA
ATGCCATCACT -> TGCCATCACTA
ATGCCGTCGAA -> TGCCGTCGAAT
ATGCGGGCTGG -> TGCGGGCTGGG
ATGCTGGGTTG -> TGCTGGGTTGG
ATGGAGGCTGG -> TGGAGGCTGGA
ATGGGATCCAC -> TGGGATCCACG
ATGGGCATTAT -> TGGGCATTATC
ATGGGTGCGAT -> TGGGTGCGATG
ATGGTTCGATG -> TGGTTCGATGA
ATGGTTCGGTT -> TGGTTCGGTTG
ATGTAATACGC -> TGTAATACGCG
ATGTAGACTTA -> TGTAGACTTAA
ATGTAGGTGAC -> TGTAGGTGACA
ATGTATACCAC -> TGTATACCACA
ATGTATGCAAT -> TGTATGCAATC
ATGTATTAGTG -> TGTATTAGTGT
ATGTCAGTTGC -> TGTCAGTTGCG
ATGTCCTTGGT -> TGTCCTTGGTG
ATGTCTGTAAG -> TGTCTGTAAGG
ATGTGATGTAA -> TGTGATGTAAT
ATGTGTTGGGT -> TGTGTTGGGTC
ATGTTATTTTA -> TGTTATTTTAA
ATGTTTGCTTA -> TGTTTGCTTAC
ATTACGAGCCT -> TTACGAGCCTC
ATTACGGCATG -> TTACGGCATGT
ATTACGTACAA -> TTACGTACAAC
ATTAGCAGGCT -> TTAGCAGGCTG
ATTAGTATATC -> TTAGTATATCA
ATTAGTGTACA -> TTAGTGTACAT
ATTATACATTG -> TTATACATTGG
ATTATCTAACG -> TTATCTAACGA
ATTATGTATAC -> TTATGTATACC
ATTATTATACA -> TTATTATACAT
ATTATTGTGAC -> TTATTGTGACA
ATTCAACAACC -> TTCAACAACCA
ATTCACATAAA -> TTCACATAAAA
ATTCCGACAGC -> TTCCGACAGCA
ATTCCTCTTCG -> TTCCTCTTCGT
ATTCCTGTGAT -> TTCCTGTGATC
ATTCGAAAATC -> TTCGAAAATCA
ATTCGACTGGA -> TTCGACTGGAT
ATTCGATTCTG -> TTCGATTCTGC
ATTCTGCACCC -> TTCTGCACCCC
ATTGATTCCGA -> TTGATTCCGAC
ATTGCTTTTGA -> TTGCTTTTGAA
ATTGGCACCTG -> TTGGCACCTGC
ATTGTGACATA -> TTGTGACATAA
ATTGTGCTACC -> TTGTGCTACCG
ATTTACGAGGT -> TTTACGAGGTG
ATTTCATCGTG -> TTTCATCGTGC
ATTTCCGTTAG -> TTTCCGTTAGT
ATTTTAAACCC -> TTTTAAACCCG
ATTTTCGCCGA -> TTTTCGCCGAG
CAAAAGGTCGC -> AAAAGGTCGCG
CAAAATACTTA -> AAAATACTTAC
CAAACTCACGA -> AAACTCACGAA
CAAATCCAACG -> AAATCCAACGT
CAAATGCCGTC -> AAATGCCGTCG
CAACAACCAGG -> AACAACCAGGG
CAACATAACGA -> AACATAACGAT
CAACCAGGGGT -> AACCAGGGGTC
CAACCCCGACG -> AACCCCGACGC
CAACGAAGCTA -> AACGAAGCTAG
CAACGTCGTAA -> AACGTCGTAAC
CAACGTGGAAG -> AACGTGGAAGT
CAACGTTCTGC -> AACGTTCTGCA
CAACTCCTTGG -> AACTCCTTGGT
CAACTGCGTTC -> AACTGCGTTCC
CAAGAGCTCCG -> AAGAGCTCCGA
CAAGCACCGCA -> AAGCACCGCAT
CAAGCTCGTAG -> AAGCTCGTAGC
CAAGGATACAA -> AAGGATACAAT
CAAGTGGGGGT -> AAGTGGGGGTT
CAAGTTCGGGT -> AAGTTCGGGTG
CAATCATAATG -> AATCATAATGT
CAATCGCCATA -> AATCGCCATAT
CAATCGGGTCC -> AATCGGGTCCA
CAATCTGTGCA -> AATCTGTGCAC
CAATGCCATCA -> AATGCCATCAC
CAATGCGGGCT -> AATGCGGGCTG
CAATTACGTAC -> AATTACGTACA
CAATTTCCGTT -> AATTTCCGTTA
CACAAATGCCG -> ACAAATGCCGT
CACACCCAAGC -> ACACCCAAGCT
CACAGACGCCT -> ACAGACGCCTG
CACAGGGATCA -> ACAGGGATCAA
CACATAAAACG -> ACATAAAACGA
CACATAAAAGT -> ACATAAAAGTC
CACCAATCGCC -> ACCAATCGCCA
CACCACCAATC -> ACCACCAATCG
CACCACCATTA -> ACCACCATTAT
CACCACTGTCT -> ACCACTGTCTC
CACCATGGGCA -> ACCATGGGCAT
CACCATTATTA -> ACCATTATTAT
CACCCAAGCTC -> ACCCAAGCTCG
CACCCATTCCT -> ACCCATTCCTC
CACCCCGTAAC -> ACCCCGTAACC
CACCGCATTAC -> ACCGCATTACG
CACCGCGCGCC -> ACCGCGCGCCC
CACCGGGACAT -> ACCGGGACATC
CACCTGCTGTT -> ACCTGCTGTTG
CACCTTAGGGG -> ACCTTAGGGGA
CACGAACTATA -> ACGAACTATAT
CACGCCACACC -> ACGCCACACCC
CACGCCCCGAG -> ACGCCCCGAGA
CACGGGTCATC -> ACGGGTCATCA
CACGGTACCTT -> ACGGTACCTTA
CACGGTAGGCC -> ACGGTAGGCCA
CACGTGGCAAG -> ACGTGGCAAGT
CACGTGGTACG -> ACGTGGTACGT
CACGTGTTAAT -> ACGTGTTAATC
CACTAAAAGTC -> ACTAAAAGTCA
CACTATACGGT -> ACTATACGGTC
CACTGTCTCCT -> ACTGTCTCCTT
CACTTCCCATG -> ACTTCCCATGA
CACTTCGTGCC -> ACTTCGTGCCT
CAGAACCCGGC -> AGAACCCGGCC
CAGAATTGATT -> AGAATTGATTC
CAGACCGCGGT -> AGACCGCGGTG
CAGACGCCTGC -> AGACGCCTGCT
CAGAGAGGAGG -> AGAGAGGAGGC
CAGATCCACGG -> AGATCCACGGT
CAGATCCGAGT -> AGATCCGAGTC
CAGCAACGTTC -> AGCAACGTTCT
CAGCACGTGGC -> AGCACGTGGCA
CAGCATTACGA -> AGCATTACGAG
CAGCCACCATG -> AGCCACCATGG
CAGCCATGCAC -> AGCCATGCACA
CAGCCGTGACT -> AGCCGTGACTC
CAGGACGAACG -> AGGACGAACGC
CAGGCACCGGG -> AGGCACCGGGA
CAGGCTGGGTA -> AGGCTGGGTAA
CAGGGATCAAG -> AGGGATCAAGG
CAGGGCAAAAT -> AGGGCAAAATA
CAGGGGGTTGT -> AGGGGGTTGTC
CAGGGGTCATC -> AGGGGTCATCT
CAGGGTGAACC -> AGGGTGAACCC
CAGTACATTTT -> AGTACATTTTC
CAGTACCAGGC -> AGTACCAGGCA
CAGTCACGGTA -> AGTCACGGTAG
CAGTCGCTTTT -> AGTCGCTTTTT
CAGTTGCGGGT -> AGTTGCGGGTG
CATAAAACGAT -> ATAAAACGATA
CATAAAAGTCG -> ATAAAAGTCGA
CATAACGATGA -> ATAACGATGAC
CATAAGAGGCC -> ATAAGAGGCCT
CATAAGTGAGG -> ATAAGTGAGGT
CATAATGTCAG -> ATAATGTCAGT
CATACTGGTAA -> ATACTGGTAAG
CATAGGAGCGG -> ATAGGAGCGGG
CATATACCGGT -> ATATACCGGTA
CATATATCGAA -> ATATATCGAAG
CATCACCCATT -> ATCACCCATTC
CATCACCTTAG -> ATCACCTTAGG
CATCACTAAAA -> ATCACTAAAAG
CATCAGGACGA -> ATCAGGACGAA
CATCAGTACAT -> ATCAGTACATT
CATCATCATTT -> ATCATCATTTC
CATCATTTCAT -> ATCATTTCATC
CATCGGCATTC -> ATCGGCATTCA
CATCGTGCTCC -> ATCGTGCTCCG
CATCTAAGAAA -> ATCTAAGAAAT
CATCTCCAAGC -> ATCTCCAAGCA
CATCTCTTTTC -> ATCTCTTTTCT
CATCTGTCTGC -> ATCTGTCTGCT
CATCTTAGAAT -> ATCTTAGAATC
CATGAAAGGTA -> ATGAAAGGTAA
CATGAAGTGGA -> ATGAAGTGGAT
CATGATGTTTG -> ATGATGTTTGC
CATGCACATAA -> ATGCACATAAA
CATGGGCATTA -> ATGGGCATTAT
CATGGTTCGGT -> ATGGTTCGGTT
CATGTCCTTGG -> ATGTCCTTGGT
CATTACGAGCC -> ATTACGAGCCT
CATTACGGCAT -> ATTACGGCATG
CATTATCTAAC -> ATTATCTAACG
CATTATTATAC -> ATTATTATACA
CATTATTGTGA -> ATTATTGTGAC
CATTCAACAAC -> ATTCAACAACC
CATTCACATAA -> ATTCACATAAA
CATTCCTCTTC -> ATTCCTCTTCG
CATTCCTGTGA -> ATTCCTGTGAT
CATTCGAAAAT -> ATTCGAAAATC
CATTGGCACCT -> ATTGGCACCTG
CATTTCATCGT -> ATTTCATCGTG
CATTTTCGCCG -> ATTTTCGCCGA
CCAACGTGGAA -> CAACGTGGAAG
CCAACTCCTTG -> CAACTCCTTGG
CCAACTGCGTT -> CAACTGCGTTC
CCAAGAGCTCC -> CAAGAGCTCCG
CCAAGCACCGC -> CAAGCACCGCA
CCAAGCTCGTA -> CAAGCTCGTAG
CCAAGTTCGGG -> CAAGTTCGGGT
CCAATCGCCAT -> CAATCGCCATA
CCAATGCGGGC -> CAATGCGGGCT
CCAATTACGTA -> CAATTACGTAC
CCAATTTCCGT -> CAATTTCCGTT
CCACAAATGCC -> CACAAATGCCG
CCACACCCAAG -> CACACCCAAGC
CCACCAATCGC -> CACCAATCGCC
CCACCACTGTC -> CACCACTGTCT
CCACCATGGGC -> CACCATGGGCA
CCACCATTATT -> CACCATTATTA
CCACGCCACAC -> CACGCCACACC
CCACGCCCCGA -> CACGCCCCGAG
CCACGGTACCT -> CACGGTACCTT
CCACTATACGG -> CACTATACGGT
CCACTGTCTCC -> CACTGTCTCCT
CCAGAATTGAT -> CAGAATTGATT
CCAGACCGCGG -> CAGACCGCGGT
CCAGCCATGCA -> CAGCCATGCAC
CCAGGCACCGG -> CAGGCACCGGG
CCAGGGGTCAT -> CAGGGGTCATC
CCATATACCGG -> CATATACCGGT
CCATCACTAAA -> CATCACTAAAA
CCATCAGGACG -> CATCAGGACGA
CCATCATCATT -> CATCATCATTT
CCATCGGCATT -> CATCGGCATTC
CCATGAAAGGT -> CATGAAAGGTA
CCATGCACATA -> CATGCACATAA
CCATGGGCATT -> CATGGGCATTA
CCATTATTATA -> CATTATTATAC
CCATTCCTCTT -> CATTCCTCTTC
CCCAAGCTCGT -> CCAAGCTCGTA
CCCAATTACGT -> CCAATTACGTA
CCCAATTTCCG -> CCAATTTCCGT
CCCAGCCATGC -> CCAGCCATGCA
CCCATCGGCAT -> CCATCGGCATT
CCCATGAAAGG -> CCATGAAAGGT
CCCATTCCTCT -> CCATTCCTCTT
CCCCAATTACG -> CCCAATTACGT
CCCCAATTTCC -> CCCAATTTCCG
CCCCCGTCCCG -> CCCCGTCCCGG
CCCCGACGCAT -> CCCGACGCATT
CCCCGAGAAAG -> CCCGAGAAAGG
CCCCGTAACCA -> CCCGTAACCAA
CCCCGTCCCGG -> CCCGTCCCGGG
CCCCTCGGCGG -> CCCTCGGCGGG
CCCGAAAGGCT -> CCGAAAGGCTA
CCCGACGCATT -> CCGACGCATTA
CCCGAGAAAGG -> CCGAGAAAGGT
CCCGCGCAAAA -> CCGCGCAAAAG
CCCGGCCCAGC -> CCGGCCCAGCC
CCCGGGTAGAA -> CCGGGTAGAAT
CCCGGTCCACG -> CCGGTCCACGC
CCCGTAACCAA -> CCGTAACCAAC
CCCGTAGTCGA -> CCGTAGTCGAC
CCCGTCCCGGG -> CCGTCCCGGGT
CCCTCGGCGGG -> CCTCGGCGGGT
CCGAAAGGCTA -> CGAAAGGCTAA
CCGAAATGTCT -> CGAAATGTCTG
CCGACAGCAAC -> CGACAGCAACG
CCGACGCATTA -> CGACGCATTAT
CCGAGAAAGGT -> CGAGAAAGGTA
CCGAGAACGTA -> CGAGAACGTAC
CCGAGCGGAGA -> CGAGCGGAGAG
CCGAGTAAAAC -> CGAGTAAAACC
CCGAGTAAACA -> CGAGTAAACAT
CCGAGTCTACA -> CGAGTCTACAA
CCGCACTTCCC -> CGCACTTCCCA
CCGCATTACGG -> CGCATTACGGC
CCGCCGGGTTA -> CGCCGGGTTAC
CCGCGCAAAAG -> CGCGCAAAAGG
CCGCGCGCCCC -> CGCGCGCCCCA
CCGCGGTGCGA -> CGCGGTGCGAT
CCGCGTTGTTA -> CGCGTTGTTAC
CCGGCAGGGGG -> CGGCAGGGGGT
CCGGCCCAGCC -> CGGCCCAGCCA
CCGGCGGCTAC -> CGGCGGCTACT
CCGGGACATCA -> CGGGACATCAC
CCGGGTAGAAT -> CGGGTAGAATT
CCGGGTTACAT -> CGGGTTACATC
CCGGTAGCTCC -> CGGTAGCTCCC
CCGGTAGGGCG -> CGGTAGGGCGT
CCGGTCCACGC -> CGGTCCACGCC
CCGGTCGGAAA -> CGGTCGGAAAG
CCGGTGTGATG -> CGGTGTGATGT
CCGTAACCAAC -> CGTAACCAACT
CCGTAGTCGAC -> CGTAGTCGACC
CCGTCATCACC -> CGTCATCACCC
CCGTCCCGGGT -> CGTCCCGGGTA
CCGTCGAATAC -> CGTCGAATACA
CCGTGACTCGT -> CGTGACTCGTC
CCGTTAGTCAT -> CGTTAGTCATA
CCTAAACATGA -> CTAAACATGAT
CCTAGCCAAGA -> CTAGCCAAGAG
CCTCCACCACT -> CTCCACCACTG
CCTCCTAAACA -> CTCCTAAACAT
CCTCGGCGGGT -> CTCGGCGGGTG
CCTCGTCGATA -> CTCGTCGATAT
CCTCGTTGTGA -> CTCGTTGTGAC
CCTCTTCGTTG -> CTCTTCGTTGA
CCTGCGTAAGA -> CTGCGTAAGAT
CCTGCTGTTGT -> CTGCTGTTGTT
CCTGCTTAACA -> CTGCTTAACAT
CCTGGGCATGA -> CTGGGCATGAA
CCTGTGATCTT -> CTGTGATCTTC
CCTGTTAGACT -> CTGTTAGACTG
CCTTAAAGCCG -> CTTAAAGCCGG
CCTTACCGAGC -> CTTACCGAGCG
CCTTAGGGGAA -> CTTAGGGGAAC
CCTTAGTGATT -> CTTAGTGATTA
CCTTGGGCTCC -> CTTGGGCTCCG
CCTTGGTGAAA -> CTTGGTGAAAT
CCTTGGTGTGC -> CTTGGTGTGCG
CCTTGTATGGT -> CTTGTATGGTT
CGAAAATCAAT -> GAAAATCAATC
CGAAAGGCTAA -> GAAAGGCTAAT
CGAAATGTCTG -> GAAATGTCTGT
CGAACGCAGCA -> GAACGCAGCAC
CGAACTATATT -> GAACTATATTC
CGAAGCTAGAG -> GAAGCTAGAGA
CGAAGTCTTTC -> GAAGTCTTTCC
CGAATACACTT -> GAATACACTTC
CGAATAGGCAG -> GAATAGGCAGC
CGACACGTGGT -> GACACGTGGTA
CGACAGCAACG -> GACAGCAACGT
CGACATAAGAG -> GACATAAGAGG
CGACCACTATA -> GACCACTATAC
CGACGCATTAT -> GACGCATTATT
CGACTAACTAC -> GACTAACTACC
CGACTACGCCG -> GACTACGCCGG
CGACTAGGGAG -> GACTAGGGAGG
CGACTGACTAA -> GACTGACTAAA
CGACTGGATTT -> GACTGGATTTA
CGAGAAAGGTA -> GAGAAAGGTAC
CGAGAACGTAC -> GAGAACGTACA
CGAGAATAGTG -> GAGAATAGTGA
CGAGCCTCGTT -> GAGCCTCGTTG
CGAGCGGAGAG -> GAGCGGAGAGG
CGAGGTAAGCA -> GAGGTAAGCAT
CGAGGTGTCGT -> GAGGTGTCGTT
CGAGTAAAACC -> GAGTAAAACCT
CGAGTAAACAT -> GAGTAAACATT
CGAGTAATCTG -> GAGTAATCTGC
CGAGTCTACAA -> GAGTCTACAAC
CGATACAGCAT -> GATACAGCATT
CGATAGTAATA -> GATAGTAATAT
CGATATTGCTT -> GATATTGCTTT
CGATCAGAGAG -> GATCAGAGAGG
CGATGAAAGGT -> GATGAAAGGTG
CGATGACATGG -> GATGACATGGT
CGATGGGTGCG -> GATGGGTGCGA
CGATGTATTAG -> GATGTATTAGT
CGATTCTGCAC -> GATTCTGCACC
CGCAAAAGGTC -> GCAAAAGGTCG
CGCAACGAAGC -> GCAACGAAGCT
CGCACAGGGAT -> GCACAGGGATC
CGCACTTCCCA -> GCACTTCCCAT
CGCAGCACGTG -> GCAGCACGTGG
CGCAGTACCAG -> GCAGTACCAGG
CGCATTACGGC -> GCATTACGGCA
CGCATTATTGT -> GCATTATTGTG
CGCCACACCCA -> GCCACACCCAA
CGCCATATACC -> GCCATATACCG
CGCCCCAATTA -> GCCCCAATTAC
CGCCCCGAGAA -> GCCCCGAGAAA
CGCCGAGAACG -> GCCGAGAACGT
CGCCGCCGGGT -> GCCGCCGGGTT
CGCCGGGTTAC -> GCCGGGTTACA
CGCCGGTGTGA -> GCCGGTGTGAT
CGCCTAGCCAA -> GCCTAGCCAAG
CGCCTGCTTAA -> GCCTGCTTAAC
CGCCTGTTAGA -> GCCTGTTAGAC
CGCGCAAAAGG -> GCGCAAAAGGT
CGCGCAACGAA -> GCGCAACGAAG
CGCGCCCCAAT -> GCGCCCCAATT
CGCGCGCCCCA -> GCGCGCCCCAA
CGCGGACCCCT -> GCGGACCCCTC
CGCGGTGCGAT -> GCGGTGCGATA
CGCGTTGTTAC -> GCGTTGTTACG
CGCTTTTTTAA -> GCTTTTTTAAT
CGGAAAGAAAT -> GGAAAGAAATG
CGGACCCCTCG -> GGACCCCTCGG
CGGACTGATTA -> GGACTGATTAT
CGGAGAGGTGG -> GGAGAGGTGGA
CGGCAGGGGGT -> GGCAGGGGGTT
CGGCATGTCCT -> GGCATGTCCTT
CGGCATTCACA -> GGCATTCACAT
CGGCCCAGCCA -> GGCCCAGCCAT
CGGCGGCTACT -> GGCGGCTACTT
CGGCGGGTGCC -> GGCGGGTGCCA
CGGCTACTTGT -> GGCTACTTGTA
CGGGACATCAC -> GGGACATCACC
CGGGAGTATCG -> GGGAGTATCGG
CGGGATATGCA -> GGGATATGCAA
CGGGCGCCGCC -> GGGCGCCGCCG
CGGGCTGGGAC -> GGGCTGGGACG
CGGGTAGAATT -> GGGTAGAATTA
CGGGTCATCAG -> GGGTCATCAGT
CGGGTCCAGAA -> GGGTCCAGAAT
CGGGTGCCATC -> GGGTGCCATCA
CGGGTGCTTCG -> GGGTGCTTCGG
CGGGTGTTACT -> GGGTGTTACTC
CGGGTTACATC -> GGGTTACATCT
CGGTACCTTAA -> GGTACCTTAAA
CGGTAGCTCCC -> GGTAGCTCCCA
CGGTAGGCCAG -> GGTAGGCCAGA
CGGTAGGGCGT -> GGTAGGGCGTT
CGGTCCACGCC -> GGTCCACGCCA
CGGTCCCCACA -> GGTCCCCACAG
CGGTCGGAAAG -> GGTCGGAAAGA
CGGTGCGATAC -> GGTGCGATACA
CGGTGTGATGT -> GGTGTGATGTG
CGGTTGAGCCT -> GGTTGAGCCTT
CGGTTTCGACA -> GGTTTCGACAC
CGTAAATCGCA -> GTAAATCGCAC
CGTAACCAACT -> GTAACCAACTC
CGTAACTACCC -> GTAACTACCCG
CGTAAGATCTT -> GTAAGATCTTC
CGTACAACGTC -> GTACAACGTCG
CGTACATAGGA -> GTACATAGGAG
CGTAGCTCAGG -> GTAGCTCAGGG
CGTAGTCGACC -> GTAGTCGACCA
CGTCATCACCC -> GTCATCACCCA
CGTCCCGGGTA -> GTCCCGGGTAG
CGTCGAATACA -> GTCGAATACAC
CGTCGACATAA -> GTCGACATAAG
CGTCGATATTG -> GTCGATATTGC
CGTCGTAACTA -> GTCGTAACTAC
CGTCTGGATGC -> GTCTGGATGCT
CGTGACGCAGT -> GTGACGCAGTA
CGTGACTCGTC -> GTGACTCGTCG
CGTGCCTCCTA -> GTGCCTCCTAA
CGTGCTCCGGC -> GTGCTCCGGCG
CGTGGAAGTGT -> GTGGAAGTGTC
CGTGGCAAGTG -> GTGGCAAGTGG
CGTGGGAATGT -> GTGGGAATGTG
CGTGGTACGTG -> GTGGTACGTGA
CGTGTTAATCG -> GTGTTAATCGA
CGTTAGACAGA -> GTTAGACAGAT
CGTTAGTCATA -> GTTAGTCATAC
CGTTCCGCACT -> GTTCCGCACTT
CGTTCCTCGTC -> GTTCCTCGTCG
CGTTCTGCATA -> GTTCTGCATAT
CGTTGAGGCCA -> GTTGAGGCCAA
CGTTGTGACTT -> GTTGTGACTTC
CGTTGTTACGT -> GTTGTTACGTC
CGTTTACACAG -> GTTTACACAGA
CTAAAACGTAA -> TAAAACGTAAA
CTAAAAGTCAC -> TAAAAGTCACC
CTAAACATGAT -> TAAACATGATG
CTAACAGAACC -> TAACAGAACCC
CTAACGATCAG -> TAACGATCAGA
CTAACTACCGT -> TAACTACCGTC
CTAAGAAATTC -> TAAGAAATTCG
CTAAGACAAAC -> TAAGACAAACT
CTAAGCCTCCA -> TAAGCCTCCAC
CTAATGGAGGC -> TAATGGAGGCT
CTACAACATAA -> TACAACATAAC
CTACCCGTAGT -> TACCCGTAGTC
CTACCGGTCGG -> TACCGGTCGGA
CTACCGTCATC -> TACCGTCATCA
CTACGCCGGTG -> TACGCCGGTGT
CTACTTGTACA -> TACTTGTACAT
CTAGAGATTGT -> TAGAGATTGTG
CTAGCCAAGAG -> TAGCCAAGAGC
CTAGGGAGGTA -> TAGGGAGGTAC
CTATACGGTCC -> TATACGGTCCC
CTATATTCGAC -> TATATTCGACT
CTCAAATCCAA -> TCAAATCCAAC
CTCACGAACTA -> TCACGAACTAT
CTCACGGGTCA -> TCACGGGTCAT
CTCAGGGCAAA -> TCAGGGCAAAA
CTCATCTTAGA -> TCATCTTAGAA
CTCCAAGCACC -> TCCAAGCACCG
CTCCACCACTG -> TCCACCACTGT
CTCCCATCGGC -> TCCCATCGGCA
CTCCGAGTAAA -> TCCGAGTAAAA,TCCGAGTAAAC
CTCCGCGTTGT -> TCCGCGTTGTT
CTCCGGCGGCT -> TCCGGCGGCTA
CTCCTAAACAT -> TCCTAAACATG
CTCCTTGGGCT -> TCCTTGGGCTC
CTCCTTGGTGA -> TCCTTGGTGAA
CTCGACTACGC -> TCGACTACGCC
CTCGAGTAATC -> TCGAGTAATCT
CTCGCCTAGCC -> TCGCCTAGCCA
CTCGGCGGGTG -> TCGGCGGGTGC
CTCGTAGCTCA -> TCGTAGCTCAG
CTCGTCGACAT -> TCGTCGACATA
CTCGTCGATAT -> TCGTCGATATT
CTCGTTGTGAC -> TCGTTGTGACT
CTCTAAGCCTC -> TCTAAGCCTCC
CTCTCAAATCC -> TCTCAAATCCA
CTCTGCCGAAA -> TCTGCCGAAAT
CTCTGCCGGTA -> TCTGCCGGTAG
CTCTTCAGATC -> TCTTCAGATCC
CTCTTCGTTGA -> TCTTCGTTGAG
CTCTTTTCTAA -> TCTTTTCTAAG
CTGAAAAACTC -> TGAAAAACTCG
CTGACTAAAAC -> TGACTAAAACG
CTGATTATGTA -> TGATTATGTAT
CTGCACCCCGT -> TGCACCCCGTA
CTGCATATATC -> TGCATATATCG
CTGCCGAAATG -> TGCCGAAATGT
CTGCCGGTAGC -> TGCCGGTAGCT
CTGCCTTGTAT -> TGCCTTGTATG
CTGCGTAAGAT -> TGCGTAAGATC
CTGCGTTCCGC -> TGCGTTCCGCA
CTGCTCACGGG -> TGCTCACGGGT
CTGCTGTTGTT -> TGCTGTTGTTC
CTGCTTAACAT -> TGCTTAACATC
CTGGATGCTGG -> TGGATGCTGGG
CTGGATGTATG -> TGGATGTATGC
CTGGATTTACG -> TGGATTTACGA
CTGGGACGTTA -> TGGGACGTTAG
CTGGGCATGAA -> TGGGCATGAAG
CTGGGTAATGT -> TGGGTAATGTA
CTGGGTTGGCT -> TGGGTTGGCTC
CTGGTAAGCCA -> TGGTAAGCCAT
CTGGTCTTCTC -> TGGTCTTCTCC
CTGTAAGGTCT -> TGTAAGGTCTA
CTGTCTCCTTG -> TGTCTCCTTGG
CTGTCTGCTCA -> TGTCTGCTCAC
CTGTGATCTTC -> TGTGATCTTCG
CTGTGCACCAC -> TGTGCACCACC
CTGTTAGACTG -> TGTTAGACTGA
CTGTTGTTCTT -> TGTTGTTCTTT
CTTAAAGCCGG -> TTAAAGCCGGC
CTTAACATCTG -> TTAACATCTGT
CTTAACTCGAC -> TTAACTCGACT
CTTACACGTGT -> TTACACGTGTT
CTTACCGAGCG -> TTACCGAGCGG
CTTACTCTCAA -> TTACTCTCAAA
CTTAGAATCGA -> TTAGAATCGAC
CTTAGGGGAAC -> TTAGGGGAACA
CTTAGTGATTA -> TTAGTGATTAG
CTTCAGATCCG -> TTCAGATCCGA
CTTCCCATGAA -> TTCCCATGAAA
CTTCGACTAGG -> TTCGACTAGGG
CTTCGGGAGTA -> TTCGGGAGTAT
CTTCGGTTTCG -> TTCGGTTTCGA
CTTCGTGCCTC -> TTCGTGCCTCC
CTTCGTTGAGG -> TTCGTTGAGGC
CTTCTCATCTT -> TTCTCATCTTA
CTTCTCCGCGT -> TTCTCCGCGTT
CTTGGGCTCCG -> TTGGGCTCCGA
CTTGGTGAAAT -> TTGGTGAAATA
CTTGGTGTGCG -> TTGGTGTGCGA
CTTGTACATTC -> TTGTACATTCC
CTTGTATGGTT -> TTGTATGGTTC
CTTTCCAACTG -> TTTCCAACTGC
CTTTGACTCTT -> TTTGACTCTTC
CTTTTCTAAGA -> TTTTCTAAGAC
CTTTTGAAAGT -> TTTTGAAAGTC
CTTTTTTAATG -> TTTTTTAATGT
GAAAAACTCGC -> AAAAACTCGCC
GAAAATCAATC -> AAAATCAATCT
GAAAGAAATGT -> AAAGAAATGTA
GAAAGCTGGTC -> AAAGCTGGTCT
GAAAGGCTAAT -> AAAGGCTAATG
GAAAGGTAATC -> AAAGGTAATCC
GAAAGGTACGA -> AAAGGTACGAG
GAAAGGTGTGA -> AAAGGTGTGAT
GAAAGTCCCCA -> AAAGTCCCCAA
GAAATACCTTA -> AAATACCTTAG
GAAATGTAGGT -> AAATGTAGGTG
GAAATGTCTGT -> AAATGTCTGTA
GAAATTCGATT -> AAATTCGATTC
GAACACCACCA -> AACACCACCAA
GAACCCGAAAG -> AACCCGAAAGG
GAACCCGGCCC -> AACCCGGCCCA
GAACGCAGCAC -> AACGCAGCACG
GAACGTACATA -> AACGTACATAG
GAACTATATTC -> AACTATATTCG
GAACTCTGCCG -> AACTCTGCCGG
GAAGCTAGAGA -> AAGCTAGAGAT
GAAGTAAAATG -> AAGTAAAATGA
GAAGTCTTTCC -> AAGTCTTTCCA
GAAGTGGATCC -> AAGTGGATCCC
GAAGTGTCGGG -> AAGTGTCGGGC
GAATACACTTC -> AATACACTTCG
GAATAGGCAGC -> AATAGGCAGCC
GAATAGTGAAG -> AATAGTGAAGT
GAATCGACTAA -> AATCGACTAAC
GAATGTGTTGG -> AATGTGTTGGG
GAATTAGCAGG -> AATTAGCAGGC
GAATTGATTCC -> AATTGATTCCG
GACAAACTCAC -> ACAAACTCACG
GACACGTGGTA -> ACACGTGGTAC
GACAGATCCAC -> ACAGATCCACG
GACAGCAACGT -> ACAGCAACGTT
GACAGCCGTGA -> ACAGCCGTGAC
GACAGTCACGG -> ACAGTCACGGT
GACATAAGAGG -> ACATAAGAGGC
GACATAAGTGA -> ACATAAGTGAG
GACATCACCTT -> ACATCACCTTA
GACATGGTTCG -> ACATGGTTCGG
GACCACTATAC -> ACCACTATACG
GACCCCTCGGC -> ACCCCTCGGCG
GACCGCGGTGC -> ACCGCGGTGCG
GACGAACGCAG -> ACGAACGCAGC
GACGCAGTACC -> ACGCAGTACCA
GACGCATTATT -> ACGCATTATTG
GACGCCTGCTT -> ACGCCTGCTTA
GACGTTAGACA -> ACGTTAGACAG
GACTAAAACGT -> ACTAAAACGTA
GACTAACTACC -> ACTAACTACCG
GACTACGCCGG -> ACTACGCCGGT
GACTAGGGAGG -> ACTAGGGAGGT
GACTCGTCGAC -> ACTCGTCGACA
GACTCTTCAGA -> ACTCTTCAGAT
GACTGAAAAAC -> ACTGAAAAACT
GACTGACTAAA -> ACTGACTAAAA
GACTGATTATG -> ACTGATTATGT
GACTGGATTTA -> ACTGGATTTAC
GACTTAACTCG -> ACTTAACTCGA
GACTTCGACTA -> ACTTCGACTAG
GAGAAAGGTAC -> AGAAAGGTACG
GAGAACGTACA -> AGAACGTACAT
GAGAATAGTGA -> AGAATAGTGAA
GAGAGGAGGCC -> AGAGGAGGCCC
GAGAGGTGGAC -> AGAGGTGGACA
GAGATTGTGCT -> AGATTGTGCTA
GAGCCTCGTTG -> AGCCTCGTTGT
GAGCCTTACCG -> AGCCTTACCGA
GAGCGGAGAGG -> AGCGGAGAGGT
GAGCGGGATAT -> AGCGGGATATG
GAGCTCCGAGT -> AGCTCCGAGTA
GAGGAGGCCCG -> AGGAGGCCCGC
GAGGCCAATGC -> AGGCCAATGCG
GAGGCCCGCGC -> AGGCCCGCGCA
GAGGCCTGCGT -> AGGCCTGCGTA
GAGGCTGGATG -> AGGCTGGATGT
GAGGTAAGCAT -> AGGTAAGCATT
GAGGTACGAGA -> AGGTACGAGAA
GAGGTATACTC -> AGGTATACTCG
GAGGTGGACAG -> AGGTGGACAGC
GAGGTGTCGTT -> AGGTGTCGTTC
GAGTAAAACCT -> AGTAAAACCTG
GAGTAAACATT -> AGTAAACATTC
GAGTAATCTGC -> AGTAATCTGCC
GAGTATCGGAC -> AGTATCGGACT
GAGTCTACAAC -> AGTCTACAACA
GATACAATGCC -> ATACAATGCCA
GATACAGCATT -> ATACAGCATTA
GATAGTAATAT -> ATAGTAATATA
GATATGCAACC -> ATATGCAACCC
GATATTGCTTT -> ATATTGCTTTT
GATCAAGGATA -> ATCAAGGATAC
GATCAGAGAGG -> ATCAGAGAGGA
GATCCACGCCC -> ATCCACGCCCC
GATCCACGGTA -> ATCCACGGTAC
GATCCCCCGTC -> ATCCCCCGTCC
GATCCGAGTCT -> ATCCGAGTCTA
GATCTTCGGGA -> ATCTTCGGGAG
GATCTTCTCAT -> ATCTTCTCATC
GATGAAAGGTG -> ATGAAAGGTGT
GATGACATGGT -> ATGACATGGTT
GATGCTGGGTT -> ATGCTGGGTTG
GATGGGATCCA -> ATGGGATCCAC
GATGGGTGCGA -> ATGGGTGCGAT
GATGTAATACG -> ATGTAATACGC
GATGTATGCAA -> ATGTATGCAAT
GATGTATTAGT -> ATGTATTAGTG
GATGTGATGTA -> ATGTGATGTAA
GATGTTTGCTT -> ATGTTTGCTTA
GATTAGTATAT -> ATTAGTATATC
GATTATGTATA -> ATTATGTATAC
GATTCCGACAG -> ATTCCGACAGC
GATTCTGCACC -> ATTCTGCACCC
GATTGTGCTAC -> ATTGTGCTACC
GATTTACGAGG -> ATTTACGAGGT
GCAAAAGGTCG -> CAAAAGGTCGC
GCAAAATACTT -> CAAAATACTTA
GCAACCCCGAC -> CAACCCCGACG
GCAACGAAGCT -> CAACGAAGCTA
GCAACGTTCTG -> CAACGTTCTGC
GCAAGTGGGGG -> CAAGTGGGGGT
GCAATCATAAT -> CAATCATAATG
GCACAGGGATC -> CACAGGGATCA
GCACATAAAAG -> CACATAAAAGT
GCACCACCATT -> CACCACCATTA
GCACCCCGTAA -> CACCCCGTAAC
GCACCGCATTA -> CACCGCATTAC
GCACCGGGACA -> CACCGGGACAT
GCACCTGCTGT -> CACCTGCTGTT
GCACGTGGCAA -> CACGTGGCAAG
GCACTTCCCAT -> CACTTCCCATG
GCAGCACGTGG -> CAGCACGTGGC
GCAGCCACCAT -> CAGCCACCATG
GCAGGCTGGGT -> CAGGCTGGGTA
GCAGGGGGTTG -> CAGGGGGTTGT
GCAGTACCAGG -> CAGTACCAGGC
GCATATATCGA -> CATATATCGAA
GCATGAAGTGG -> CATGAAGTGGA
GCATGTCCTTG -> CATGTCCTTGG
GCATTACGAGC -> CATTACGAGCC
GCATTACGGCA -> CATTACGGCAT
GCATTATCTAA -> CATTATCTAAC
GCATTATTGTG -> CATTATTGTGA
GCATTCACATA -> CATTCACATAA
GCATTCGAAAA -> CATTCGAAAAT
GCCAAGAGCTC -> CCAAGAGCTCC
GCCAATGCGGG -> CCAATGCGGGC
GCCACACCCAA -> CCACACCCAAG
GCCACCATGGG -> CCACCATGGGC
GCCAGACCGCG -> CCAGACCGCGG
GCCATATACCG -> CCATATACCGG
GCCATCACTAA -> CCATCACTAAA
GCCATCAGGAC -> CCATCAGGACG
GCCATCATCAT -> CCATCATCATT
GCCATGCACAT -> CCATGCACATA
GCCCAGCCATG -> CCCAGCCATGC
GCCCCAATTAC -> CCCCAATTACG
GCCCCGAGAAA -> CCCCGAGAAAG
GCCCGCGCAAA -> CCCGCGCAAAA
GCCGAAATGTC -> CCGAAATGTCT
GCCGAGAACGT -> CCGAGAACGTA
GCCGCCGGGTT -> CCGCCGGGTTA
GCCGGCAGGGG -> CCGGCAGGGGG
GCCGGGTTACA -> CCGGGTTACAT
GCCGGTAGCTC -> CCGGTAGCTCC
GCCGGTGTGAT -> CCGGTGTGATG
GCCGTCGAATA -> CCGTCGAATAC
GCCGTGACTCG -> CCGTGACTCGT
GCCTAGCCAAG -> CCTAGCCAAGA
GCCTCCACCAC -> CCTCCACCACT
GCCTCCTAAAC -> CCTCCTAAACA
GCCTCGTTGTG -> CCTCGTTGTGA
GCCTGCGTAAG -> CCTGCGTAAGA
GCCTGCTTAAC -> CCTGCTTAACA
GCCTGTTAGAC -> CCTGTTAGACT
GCCTTACCGAG -> CCTTACCGAGC
GCCTTGTATGG -> CCTTGTATGGT
GCGATACAGCA -> CGATACAGCAT
GCGATGGGTGC -> CGATGGGTGCG
GCGATGTATTA -> CGATGTATTAG
GCGCAAAAGGT -> CGCAAAAGGTC
GCGCAACGAAG -> CGCAACGAAGC
GCGCCCCAATT -> CGCCCCAATTA
GCGCCGCCGGG -> CGCCGCCGGGT
GCGCGCCCCAA -> CGCGCCCCAAT
GCGGACCCCTC -> CGGACCCCTCG
GCGGAGAGGTG -> CGGAGAGGTGG
GCGGCTACTTG -> CGGCTACTTGT
GCGGGATATGC -> CGGGATATGCA
GCGGGCTGGGA -> CGGGCTGGGAC
GCGGGTGCCAT -> CGGGTGCCATC
GCGGGTGTTAC -> CGGGTGTTACT
GCGGTGCGATA -> CGGTGCGATAC
GCGTAAGATCT -> CGTAAGATCTT
GCGTTCCGCAC -> CGTTCCGCACT
GCGTTGTTACG -> CGTTGTTACGT
GCGTTTACACA -> CGTTTACACAG
GCTAATGGAGG -> CTAATGGAGGC
GCTACCGGTCG -> CTACCGGTCGG
GCTACTTGTAC -> CTACTTGTACA
GCTAGAGATTG -> CTAGAGATTGT
GCTCACGGGTC -> CTCACGGGTCA
GCTCAGGGCAA -> CTCAGGGCAAA
GCTCCCATCGG -> CTCCCATCGGC
GCTCCGAGTAA -> CTCCGAGTAAA,CTCCGAGTAAA
GCTCCGGCGGC -> CTCCGGCGGCT
GCTCGTAGCTC -> CTCGTAGCTCA
GCTCTGCCGAA -> CTCTGCCGAAA
GCTGGATGTAT -> CTGGATGTATG
GCTGGGACGTT -> CTGGGACGTTA
GCTGGGTAATG -> CTGGGTAATGT
GCTGGGTTGGC -> CTGGGTTGGCT
GCTGGTCTTCT -> CTGGTCTTCTC
GCTGTTGTTCT -> CTGTTGTTCTT
GCTTAACATCT -> CTTAACATCTG
GCTTACACGTG -> CTTACACGTGT
GCTTCGGTTTC -> CTTCGGTTTCG
GCTTTTGAAAG -> CTTTTGAAAGT
GCTTTTTTAAT -> CTTTTTTAATG
GGAAAGAAATG -> GAAAGAAATGT
GGAACACCACC -> GAACACCACCA
GGAAGTGTCGG -> GAAGTGTCGGG
GGAATGTGTTG -> GAATGTGTTGG
GGACAGCCGTG -> GACAGCCGTGA
GGACATCACCT -> GACATCACCTT
GGACCCCTCGG -> GACCCCTCGGC
GGACGAACGCA -> GACGAACGCAG
GGACGTTAGAC -> GACGTTAGACA
GGACTGATTAT -> GACTGATTATG
GGAGAGGTGGA -> GAGAGGTGGAC
GGAGCGGGATA -> GAGCGGGATAT
GGAGGCCCGCG -> GAGGCCCGCGC
GGAGGCTGGAT -> GAGGCTGGATG
GGAGGTACGAG -> GAGGTACGAGA
GGAGTATCGGA -> GAGTATCGGAC
GGATACAATGC -> GATACAATGCC
GGATATGCAAC -> GATATGCAACC
GGATCAAGGAT -> GATCAAGGATA
GGATCCACGCC -> GATCCACGCCC
GGATCCCCCGT -> GATCCCCCGTC
GGATGCTGGGT -> GATGCTGGGTT
GGATGTATGCA -> GATGTATGCAA
GGATTTACGAG -> GATTTACGAGG
GGCAAAATACT -> GCAAAATACTT
GGCAAGTGGGG -> GCAAGTGGGGG
GGCACCGGGAC -> GCACCGGGACA
GGCACCTGCTG -> GCACCTGCTGT
GGCAGCCACCA -> GCAGCCACCAT
GGCAGGGGGTT -> GCAGGGGGTTG
GGCATGAAGTG -> GCATGAAGTGG
GGCATGTCCTT -> GCATGTCCTTG
GGCATTATCTA -> GCATTATCTAA
GGCATTCACAT -> GCATTCACATA
GGCCAATGCGG -> GCCAATGCGGG
GGCCAGACCGC -> GCCAGACCGCG
GGCCCAGCCAT -> GCCCAGCCATG
GGCCCGCGCAA -> GCCCGCGCAAA
GGCCTGCGTAA -> GCCTGCGTAAG
GGCGCCGCCGG -> GCGCCGCCGGG
GGCGGCTACTT -> GCGGCTACTTG
GGCGGGTGCCA -> GCGGGTGCCAT
GGCGTTTACAC -> GCGTTTACACA
GGCTAATGGAG -> GCTAATGGAGG
GGCTACTTGTA -> GCTACTTGTAC
GGCTCCGAGTA -> GCTCCGAGTAA
GGCTCTGCCGA -> GCTCTGCCGAA
GGCTGGATGTA -> GCTGGATGTAT
GGCTGGGACGT -> GCTGGGACGTT
GGCTGGGTAAT -> GCTGGGTAATG
GGGAACACCAC -> GGAACACCACC
GGGAATGTGTT -> GGAATGTGTTG
GGGACATCACC -> GGACATCACCT
GGGACGTTAGA -> GGACGTTAGAC
GGGAGGTACGA -> GGAGGTACGAG
GGGAGTATCGG -> GGAGTATCGGA
GGGATATGCAA -> GGATATGCAAC
GGGATCAAGGA -> GGATCAAGGAT
GGGATCCACGC -> GGATCCACGCC
GGGCAAAATAC -> GGCAAAATACT
GGGCATGAAGT -> GGCATGAAGTG
GGGCATTATCT -> GGCATTATCTA
GGGCGCCGCCG -> GGCGCCGCCGG
GGGCGTTTACA -> GGCGTTTACAC
GGGCTCCGAGT -> GGCTCCGAGTA
GGGCTGGGACG -> GGCTGGGACGT
GGGGAACACCA -> GGGAACACCAC
GGGGGTTCAGT -> GGGGTTCAGTC
GGGGGTTGTCG -> GGGGTTGTCGT
GGGGTCATCTC -> GGGTCATCTCT
GGGGTTCAGTC -> GGGTTCAGTCG
GGGGTTGTCGT -> GGGTTGTCGTG
GGGTAATGTAG -> GGTAATGTAGA
GGGTAGAATTA -> GGTAGAATTAG
GGGTCATCAGT -> GGTCATCAGTA
GGGTCATCTCT -> GGTCATCTCTT
GGGTCCAGAAT -> GGTCCAGAATT
GGGTCGCCTGT -> GGTCGCCTGTT
GGGTGAACCCG -> GGTGAACCCGA
GGGTGCCATCA -> GGTGCCATCAG
GGGTGCGATGT -> GGTGCGATGTA
GGGTGCTTCGG -> GGTGCTTCGGT
GGGTGTTACTC -> GGTGTTACTCT
GGGTTACATCT -> GGTTACATCTC
GGGTTCAGTCG -> GGTTCAGTCGC
GGGTTGGCTCT -> GGTTGGCTCTG
GGGTTGTCGTG -> GGTTGTCGTGG
GGTAAGCATTC -> GTAAGCATTCG
GGTAAGCCATC -> GTAAGCCATCA
GGTAATCCAAG -> GTAATCCAAGT
GGTAATGTAGA -> GTAATGTAGAC
GGTACCTTAAA -> GTACCTTAAAG
GGTACGAGAAT -> GTACGAGAATA
GGTACGAGGTA -> GTACGAGGTAA
GGTACGTGACG -> GTACGTGACGC
GGTAGAATTAG -> GTAGAATTAGC
GGTAGCTCCCA -> GTAGCTCCCAT
GGTAGGCCAGA -> GTAGGCCAGAC
GGTAGGGCGTT -> GTAGGGCGTTT
GGTATACTCGA -> GTATACTCGAG
GGTCATCAGTA -> GTCATCAGTAC
GGTCATCTCTT -> GTCATCTCTTT
GGTCCACGCCA -> GTCCACGCCAC
GGTCCAGAATT -> GTCCAGAATTG
GGTCCCCACAG -> GTCCCCACAGC
GGTCGCCTGTT -> GTCGCCTGTTA
GGTCGCGGACC -> GTCGCGGACCC
GGTCGGAAAGA -> GTCGGAAAGAA
GGTCTAACAGA -> GTCTAACAGAA
GGTCTTCTCCG -> GTCTTCTCCGC
GGTGAAATACC -> GTGAAATACCT
GGTGAACCCGA -> GTGAACCCGAA
GGTGACAGTCA -> GTGACAGTCAC
GGTGCCATCAG -> GTGCCATCAGG
GGTGCGATACA -> GTGCGATACAG
GGTGCGATGTA -> GTGCGATGTAT
GGTGCTTCGGT -> GTGCTTCGGTT
GGTGGACAGCC -> GTGGACAGCCG
GGTGTCGTTCC -> GTGTCGTTCCT
GGTGTGATGGG -> GTGTGATGGGA
GGTGTGATGTG -> GTGTGATGTGA
GGTGTGCGATG -> GTGTGCGATGG
GGTGTTACTCT -> GTGTTACTCTA
GGTTACATCTC -> GTTACATCTCC
GGTTCAGTCGC -> GTTCAGTCGCT
GGTTCGATGAA -> GTTCGATGAAA
GGTTCGGTTGA -> GTTCGGTTGAG
GGTTGAGCCTT -> GTTGAGCCTTA
GGTTGGCTCTG -> GTTGGCTCTGC
GGTTGTCGTGG -> GTTGTCGTGGG
GGTTTCGACAC -> GTTTCGACACG
GTAAAACCTGG -> TAAAACCTGGG
GTAAAATGAAC -> TAAAATGAACT
GTAAACATTCA -> TAAACATTCAA
GTAAATCGCAC -> TAAATCGCACA
GTAACCAACTC -> TAACCAACTCC
GTAACTACCCG -> TAACTACCCGT
GTAAGATCTTC -> TAAGATCTTCT
GTAAGCATTCG -> TAAGCATTCGA
GTAAGCCATCA -> TAAGCCATCAT
GTAAGGTCTAA -> TAAGGTCTAAC
GTAATACGCGC -> TAATACGCGCA
GTAATATAGTG -> TAATATAGTGT
GTAATCCAAGT -> TAATCCAAGTT
GTAATCTGCCT -> TAATCTGCCTT
GTAATGTAGAC -> TAATGTAGACT
GTACAACGTCG -> TACAACGTCGT
GTACAATCGGG -> TACAATCGGGT
GTACATAGGAG -> TACATAGGAGC
GTACATCTAAG -> TACATCTAAGA
GTACATTCCTG -> TACATTCCTGT
GTACATTTTCG -> TACATTTTCGC
GTACCAGGCAC -> TACCAGGCACC
GTACCTTAAAG -> TACCTTAAAGC
GTACGAGAATA -> TACGAGAATAG
GTACGAGGTAA -> TACGAGGTAAG
GTACGTGACGC -> TACGTGACGCA
GTAGAATTAGC -> TAGAATTAGCA
GTAGACTTAAC -> TAGACTTAACT
GTAGCTCAGGG -> TAGCTCAGGGC
GTAGCTCCCAT -> TAGCTCCCATC
GTAGGCCAGAC -> TAGGCCAGACC
GTAGGGCGTTT -> TAGGGCGTTTA
GTAGGTGACAG -> TAGGTGACAGT
GTAGTCGACCA -> TAGTCGACCAC
GTATACCACAA -> TATACCACAAA
GTATACTCGAG -> TATACTCGAGT
GTATATCAGGG -> TATATCAGGGT
GTATCGGACTG -> TATCGGACTGA
GTATGCAATCA -> TATGCAATCAT
GTATGGTTCGA -> TATGGTTCGAT
GTATTAGTGTA -> TATTAGTGTAC
GTCACCGCGCG -> TCACCGCGCGC
GTCACGGTAGG -> TCACGGTAGGC
GTCAGTTGCGG -> TCAGTTGCGGG
GTCATACTGGT -> TCATACTGGTA
GTCATCACCCA -> TCATCACCCAT
GTCATCAGTAC -> TCATCAGTACA
GTCATCTCTTT -> TCATCTCTTTT
GTCCACGCCAC -> TCCACGCCACA
GTCCAGAATTG -> TCCAGAATTGA
GTCCCCAATTT -> TCCCCAATTTC
GTCCCGGGTAG -> TCCCGGGTAGA
GTCCTTGGTGT -> TCCTTGGTGTG
GTCGAATACAC -> TCGAATACACT
GTCGAATAGGC -> TCGAATAGGCA
GTCGACATAAG -> TCGACATAAGA
GTCGACCACTA -> TCGACCACTAT
GTCGATATTGC -> TCGATATTGCT
GTCGCCTGTTA -> TCGCCTGTTAG
GTCGCGGACCC -> TCGCGGACCCC
GTCGCTTTTTT -> TCGCTTTTTTA
GTCGGAAAGAA -> TCGGAAAGAAA
GTCGGGCGCCG -> TCGGGCGCCGC
GTCGTAACTAC -> TCGTAACTACC
GTCGTGGGAAT -> TCGTGGGAATG
GTCGTTCCTCG -> TCGTTCCTCGT
GTCTAACAGAA -> TCTAACAGAAC
GTCTACAACAT -> TCTACAACATA
GTCTCCTTGGG -> TCTCCTTGGGC
GTCTGCTCACG -> TCTGCTCACGG
GTCTGGATGCT -> TCTGGATGCTG
GTCTGTAAGGT -> TCTGTAAGGTC
GTCTTCTCCGC -> TCTTCTCCGCG
GTCTTTCCAAC -> TCTTTCCAACT
GTGAAATACCT -> TGAAATACCTT
GTGAACCCGAA -> TGAACCCGAAA
GTGAAGTAAAA -> TGAAGTAAAAT
GTGACAGTCAC -> TGACAGTCACG
GTGACATAAGT -> TGACATAAGTG
GTGACGCAGTA -> TGACGCAGTAC
GTGACTCGTCG -> TGACTCGTCGA
GTGACTTCGAC -> TGACTTCGACT
GTGAGGTATAC -> TGAGGTATACT
GTGATCTTCGG -> TGATCTTCGGG
GTGATGGGATC -> TGATGGGATCC
GTGATGTAATA -> TGATGTAATAC
GTGATGTGATG -> TGATGTGATGT
GTGATTAGTAT -> TGATTAGTATA
GTGCACCACCA -> TGCACCACCAT
GTGCCATCAGG -> TGCCATCAGGA
GTGCCTCCTAA -> TGCCTCCTAAA
GTGCGATACAG -> TGCGATACAGC
GTGCGATGGGT -> TGCGATGGGTG
GTGCGATGTAT -> TGCGATGTATT
GTGCTACCGGT -> TGCTACCGGTC
GTGCTCCGGCG -> TGCTCCGGCGG
GTGCTTCGGTT -> TGCTTCGGTTT
GTGGAAGTGTC -> TGGAAGTGTCG
GTGGACAGCCG -> TGGACAGCCGT
GTGGATCCCCC -> TGGATCCCCCG
GTGGCAAGTGG -> TGGCAAGTGGG
GTGGGAATGTG -> TGGGAATGTGT
GTGGGGGTTCA -> TGGGGGTTCAG
GTGGTACGTGA -> TGGTACGTGAC
GTGTACAATCG -> TGTACAATCGG
GTGTACATCTA -> TGTACATCTAA
GTGTCGGGCGC -> TGTCGGGCGCC
GTGTCGTTCCT -> TGTCGTTCCTC
GTGTGATGGGA -> TGTGATGGGAT
GTGTGATGTGA -> TGTGATGTGAT
GTGTGCGATGG -> TGTGCGATGGG
GTGTTAATCGA -> TGTTAATCGAC
GTGTTACTCTA -> TGTTACTCTAA
GTGTTGGGTCG -> TGTTGGGTCGC
GTTAATCGACT -> TTAATCGACTG
GTTACATCTCC -> TTACATCTCCA
GTTACGTCTGG -> TTACGTCTGGA
GTTACTCTAAG -> TTACTCTAAGC
GTTAGACAGAT -> TTAGACAGATC
GTTAGACTGAA -> TTAGACTGAAA
GTTAGTCATAC -> TTAGTCATACT
GTTATTTTAAA -> TTATTTTAAAC
GTTCAGTCGCT -> TTCAGTCGCTT
GTTCCGCACTT -> TTCCGCACTTC
GTTCCTCGTCG -> TTCCTCGTCGA
GTTCGATGAAA -> TTCGATGAAAG
GTTCGGGTGCT -> TTCGGGTGCTT
GTTCGGTTGAG -> TTCGGTTGAGC
GTTCTGCATAT -> TTCTGCATATA
GTTCTTTGACT -> TTCTTTGACTC
GTTGAGCCTTA -> TTGAGCCTTAC
GTTGAGGCCAA -> TTGAGGCCAAT
GTTGCGGGTGT -> TTGCGGGTGTT
GTTGGCTCTGC -> TTGGCTCTGCC
GTTGGGTCGCC -> TTGGGTCGCCT
GTTGTCGTGGG -> TTGTCGTGGGA
GTTGTGACTTC -> TTGTGACTTCG
GTTGTTACGTC -> TTGTTACGTCT
GTTGTTCTTTG -> TTGTTCTTTGA
GTTTACACAGA -> TTTACACAGAC
GTTTCGACACG -> TTTCGACACGT
GTTTGCTTACA -> TTTGCTTACAC
TAAAACCTGGG -> AAAACCTGGGC
TAAAACGATAG -> AAAACGATAGT
TAAAACGTAAA -> AAAACGTAAAT
TAAAAGTCACC -> AAAAGTCACCG
TAAAAGTCGAA -> AAAAGTCGAAT
TAAAATGAACT -> AAAATGAACTC
TAAACATGATG -> AAACATGATGT
TAAACATTCAA -> AAACATTCAAC
TAAACCCGGTC -> AAACCCGGTCC
TAAAGCCGGCA -> AAAGCCGGCAG
TAAATCGCACA -> AAATCGCACAG
TAACAGAACCC -> AACAGAACCCG
TAACATCTGTC -> AACATCTGTCT
TAACCAACTCC -> AACCAACTCCT
TAACGATCAGA -> AACGATCAGAG
TAACGATGACA -> AACGATGACAT
TAACTACCCGT -> AACTACCCGTA
TAACTACCGTC -> AACTACCGTCA
TAACTCGACTA -> AACTCGACTAC
TAAGAAATTCG -> AAGAAATTCGA
TAAGACAAACT -> AAGACAAACTC
TAAGAGGCCTG -> AAGAGGCCTGC
TAAGATCTTCT -> AAGATCTTCTC
TAAGCATTCGA -> AAGCATTCGAA
TAAGCCATCAT -> AAGCCATCATC
TAAGCCTCCAC -> AAGCCTCCACC
TAAGGTCTAAC -> AAGGTCTAACA
TAAGTGAGGTA -> AAGTGAGGTAT
TAATACGCGCA -> AATACGCGCAA
TAATATAGTGT -> AATATAGTGTA
TAATCCAAGTT -> AATCCAAGTTC
TAATCGACTGA -> AATCGACTGAC
TAATCTGCCTT -> AATCTGCCTTG
TAATGGAGGCT -> AATGGAGGCTG
TAATGTAGACT -> AATGTAGACTT
TAATGTCAGTT -> AATGTCAGTTG
TAATGTTATTT -> AATGTTATTTT
TACAACATAAC -> ACAACATAACG
TACAACGTCGT -> ACAACGTCGTA
TACAATCGGGT -> ACAATCGGGTC
TACAATGCCAT -> ACAATGCCATC
TACACAGACGC -> ACACAGACGCC
TACACGTGTTA -> ACACGTGTTAA
TACACTTCGTG -> ACACTTCGTGC
TACAGCATTAC -> ACAGCATTACG
TACATAGGAGC -> ACATAGGAGCG
TACATCTAAGA -> ACATCTAAGAA
TACATCTCCAA -> ACATCTCCAAG
TACATTCCTGT -> ACATTCCTGTG
TACATTGGCAC -> ACATTGGCACC
TACATTTTCGC -> ACATTTTCGCC
TACCACAAATG -> ACCACAAATGC
TACCAGGCACC -> ACCAGGCACCG
TACCCGTAGTC -> ACCCGTAGTCG
TACCGAGCGGA -> ACCGAGCGGAG
TACCGGTAGGG -> ACCGGTAGGGC
TACCGGTCGGA -> ACCGGTCGGAA
TACCGTCATCA -> ACCGTCATCAC
TACCTTAAAGC -> ACCTTAAAGCC
TACCTTAGTGA -> ACCTTAGTGAT
TACGAGAATAG -> ACGAGAATAGT
TACGAGCCTCG -> ACGAGCCTCGT
TACGAGGTAAG -> ACGAGGTAAGC
TACGAGGTGTC -> ACGAGGTGTCG
TACGCCGGTGT -> ACGCCGGTGTG
TACGCGCAACG -> ACGCGCAACGA
TACGGCATGTC -> ACGGCATGTCC
TACGGTCCCCA -> ACGGTCCCCAC
TACGTACAACG -> ACGTACAACGT
TACGTCTGGAT -> ACGTCTGGATG
TACGTGACGCA -> ACGTGACGCAG
TACTCGAGTAA -> ACTCGAGTAAT
TACTCTAAGCC -> ACTCTAAGCCT
TACTCTCAAAT -> ACTCTCAAATC
TACTGGTAAGC -> ACTGGTAAGCC
TACTTACTCTC -> ACTTACTCTCA
TACTTGTACAT -> ACTTGTACATT
TAGAATCGACT -> AGAATCGACTA
TAGAATTAGCA -> AGAATTAGCAG
TAGACAGATCC -> AGACAGATCCA
TAGACTGAAAA -> AGACTGAAAAA
TAGACTTAACT -> AGACTTAACTC
TAGAGATTGTG -> AGAGATTGTGC
TAGCAGGCTGG -> AGCAGGCTGGG
TAGCCAAGAGC -> AGCCAAGAGCT
TAGCTCAGGGC -> AGCTCAGGGCA
TAGCTCCCATC -> AGCTCCCATCG
TAGGAGCGGGA -> AGGAGCGGGAT
TAGGCAGCCAC -> AGGCAGCCACC
TAGGCCAGACC -> AGGCCAGACCG
TAGGGAGGTAC -> AGGGAGGTACG
TAGGGCGTTTA -> AGGGCGTTTAC
TAGGGGAACAC -> AGGGGAACACC
TAGGTGACAGT -> AGGTGACAGTC
TAGTAATATAG -> AGTAATATAGT
TAGTATATCAG -> AGTATATCAGG
TAGTCATACTG -> AGTCATACTGG
TAGTCGACCAC -> AGTCGACCACT
TAGTGAAGTAA -> AGTGAAGTAAA
TAGTGATTAGT -> AGTGATTAGTA
TAGTGTACAAT -> AGTGTACAATC
TAGTGTACATC -> AGTGTACATCT
TATACATTGGC -> ATACATTGGCA
TATACCACAAA -> ATACCACAAAT
TATACCGGTAG -> ATACCGGTAGG
TATACGGTCCC -> ATACGGTCCCC
TATACTCGAGT -> ATACTCGAGTA
TATAGTGTACA -> ATAGTGTACAA
TATATCAGGGT -> ATATCAGGGTG
TATATCGAAGT -> ATATCGAAGTC
TATATTCGACT -> ATATTCGACTG
TATCAGGGTGA -> ATCAGGGTGAA
TATCGAAGTCT -> ATCGAAGTCTT
TATCGGACTGA -> ATCGGACTGAT
TATCTAACGAT -> ATCTAACGATC
TATGCAACCCC -> ATGCAACCCCG
TATGCAATCAT -> ATGCAATCATA
TATGGTTCGAT -> ATGGTTCGATG
TATGTATACCA -> ATGTATACCAC
TATTAGTGTAC -> ATTAGTGTACA
TATTATACATT -> ATTATACATTG
TATTCGACTGG -> ATTCGACTGGA
TATTGCTTTTG -> ATTGCTTTTGA
TATTGTGACAT -> ATTGTGACATA
TATTTTAAACC -> ATTTTAAACCC
TCAAATCCAAC -> CAAATCCAACG
TCAACAACCAG -> CAACAACCAGG
TCAAGGATACA -> CAAGGATACAA
TCAATCTGTGC -> CAATCTGTGCA
TCACATAAAAC -> CACATAAAACG
TCACCCATTCC -> CACCCATTCCT
TCACCGCGCGC -> CACCGCGCGCC
TCACCTTAGGG -> CACCTTAGGGG
TCACGAACTAT -> CACGAACTATA
TCACGGGTCAT -> CACGGGTCATC
TCACGGTAGGC -> CACGGTAGGCC
TCACTAAAAGT -> CACTAAAAGTC
TCAGAGAGGAG -> CAGAGAGGAGG
TCAGATCCGAG -> CAGATCCGAGT
TCAGGACGAAC -> CAGGACGAACG
TCAGGGCAAAA -> CAGGGCAAAAT
TCAGGGTGAAC -> CAGGGTGAACC
TCAGTACATTT -> CAGTACATTTT
TCAGTCGCTTT -> CAGTCGCTTTT
TCAGTTGCGGG -> CAGTTGCGGGT
TCATAATGTCA -> CATAATGTCAG
TCATACTGGTA -> CATACTGGTAA
TCATCACCCAT -> CATCACCCATT
TCATCAGTACA -> CATCAGTACAT
TCATCATTTCA -> CATCATTTCAT
TCATCGTGCTC -> CATCGTGCTCC
TCATCTCTTTT -> CATCTCTTTTC
TCATCTTAGAA -> CATCTTAGAAT
TCATTTCATCG -> CATTTCATCGT
TCCAACGTGGA -> CCAACGTGGAA
TCCAACTGCGT -> CCAACTGCGTT
TCCAAGCACCG -> CCAAGCACCGC
TCCAAGTTCGG -> CCAAGTTCGGG
TCCACCACTGT -> CCACCACTGTC
TCCACGCCACA -> CCACGCCACAC
TCCACGCCCCG -> CCACGCCCCGA
TCCACGGTACC -> CCACGGTACCT
TCCAGAATTGA -> CCAGAATTGAT
TCCCATCGGCA -> CCCATCGGCAT
TCCCATGAAAG -> CCCATGAAAGG
TCCCCAATTTC -> CCCCAATTTCC
TCCCCCGTCCC -> CCCCCGTCCCG
TCCCGGGTAGA -> CCCGGGTAGAA
TCCGACAGCAA -> CCGACAGCAAC
TCCGAGTAAAA -> CCGAGTAAAAC
TCCGAGTAAAC -> CCGAGTAAACA
TCCGAGTCTAC -> CCGAGTCTACA
TCCGCACTTCC -> CCGCACTTCCC
TCCGCGTTGTT -> CCGCGTTGTTA
TCCGGCGGCTA -> CCGGCGGCTAC
TCCGTTAGTCA -> CCGTTAGTCAT
TCCTAAACATG -> CCTAAACATGA
TCCTCGTCGAT -> CCTCGTCGATA
TCCTCTTCGTT -> CCTCTTCGTTG
TCCTGTGATCT -> CCTGTGATCTT
TCCTTGGGCTC -> CCTTGGGCTCC
TCCTTGGTGAA -> CCTTGGTGAAA
TCCTTGGTGTG -> CCTTGGTGTGC
TCGAAAATCAA -> CGAAAATCAAT
TCGAAGTCTTT -> CGAAGTCTTTC
TCGAATACACT -> CGAATACACTT
TCGAATAGGCA -> CGAATAGGCAG
TCGACACGTGG -> CGACACGTGGT
TCGACATAAGA -> CGACATAAGAG
TCGACCACTAT -> CGACCACTATA
TCGACTAACTA -> CGACTAACTAC
TCGACTACGCC -> CGACTACGCCG
TCGACTAGGGA -> CGACTAGGGAG
TCGACTGACTA -> CGACTGACTAA
TCGACTGGATT -> CGACTGGATTT
TCGAGTAATCT -> CGAGTAATCTG
TCGATATTGCT -> CGATATTGCTT
TCGATGAAAGG -> CGATGAAAGGT
TCGATTCTGCA -> CGATTCTGCAC
TCGCACAGGGA -> CGCACAGGGAT
TCGCCATATAC -> CGCCATATACC
TCGCCGAGAAC -> CGCCGAGAACG
TCGCCTAGCCA -> CGCCTAGCCAA
TCGCCTGTTAG -> CGCCTGTTAGA
TCGCGGACCCC -> CGCGGACCCCT
TCGCTTTTTTA -> CGCTTTTTTAA
TCGGAAAGAAA -> CGGAAAGAAAT
TCGGACTGATT -> CGGACTGATTA
TCGGCATTCAC -> CGGCATTCACA
TCGGCGGGTGC -> CGGCGGGTGCC
TCGGGAGTATC -> CGGGAGTATCG
TCGGGCGCCGC -> CGGGCGCCGCC
TCGGGTCCAGA -> CGGGTCCAGAA
TCGGGTGCTTC -> CGGGTGCTTCG
TCGGTTGAGCC -> CGGTTGAGCCT
TCGGTTTCGAC -> CGGTTTCGACA
TCGTAACTACC -> CGTAACTACCC
TCGTAGCTCAG -> CGTAGCTCAGG
TCGTCGACATA -> CGTCGACATAA
TCGTCGATATT -> CGTCGATATTG
TCGTGCCTCCT -> CGTGCCTCCTA
TCGTGCTCCGG -> CGTGCTCCGGC
TCGTGGGAATG -> CGTGGGAATGT
TCGTTCCTCGT -> CGTTCCTCGTC
TCGTTGAGGCC -> CGTTGAGGCCA
TCGTTGTGACT -> CGTTGTGACTT
TCTAACAGAAC -> CTAACAGAACC
TCTAACGATCA -> CTAACGATCAG
TCTAAGAAATT -> CTAAGAAATTC
TCTAAGACAAA -> CTAAGACAAAC
TCTAAGCCTCC -> CTAAGCCTCCA
TCTACAACATA -> CTACAACATAA
TCTCAAATCCA -> CTCAAATCCAA
TCTCATCTTAG -> CTCATCTTAGA
TCTCCAAGCAC -> CTCCAAGCACC
TCTCCGCGTTG -> CTCCGCGTTGT
TCTCCTTGGGC -> CTCCTTGGGCT
TCTCTTTTCTA -> CTCTTTTCTAA
TCTGCACCCCG -> CTGCACCCCGT
TCTGCATATAT -> CTGCATATATC
TCTGCCGAAAT -> CTGCCGAAATG
TCTGCCGGTAG -> CTGCCGGTAGC
TCTGCCTTGTA -> CTGCCTTGTAT
TCTGCTCACGG -> CTGCTCACGGG
TCTGGATGCTG -> CTGGATGCTGG
TCTGTAAGGTC -> CTGTAAGGTCT
TCTGTCTGCTC -> CTGTCTGCTCA
TCTGTGCACCA -> CTGTGCACCAC
TCTTAGAATCG -> CTTAGAATCGA
TCTTCAGATCC -> CTTCAGATCCG
TCTTCGGGAGT -> CTTCGGGAGTA
TCTTCGTTGAG -> CTTCGTTGAGG
TCTTCTCATCT -> CTTCTCATCTT
TCTTCTCCGCG -> CTTCTCCGCGT
TCTTTCCAACT -> CTTTCCAACTG
TCTTTGACTCT -> CTTTGACTCTT
TCTTTTCTAAG -> CTTTTCTAAGA
TGAAAAACTCG -> GAAAAACTCGC
TGAAAGGTAAT -> GAAAGGTAATC
TGAAAGGTGTG -> GAAAGGTGTGA
TGAAAGTCCCC -> GAAAGTCCCCA
TGAAATACCTT -> GAAATACCTTA
TGAACCCGAAA -> GAACCCGAAAG
TGAACTCTGCC -> GAACTCTGCCG
TGAAGTAAAAT -> GAAGTAAAATG
TGAAGTGGATC -> GAAGTGGATCC
TGACAGTCACG -> GACAGTCACGG
TGACATAAGTG -> GACATAAGTGA
TGACATGGTTC -> GACATGGTTCG
TGACGCAGTAC -> GACGCAGTACC
TGACTAAAACG -> GACTAAAACGT
TGACTCGTCGA -> GACTCGTCGAC
TGACTCTTCAG -> GACTCTTCAGA
TGACTTCGACT -> GACTTCGACTA
TGAGCCTTACC -> GAGCCTTACCG
TGAGGCCAATG -> GAGGCCAATGC
TGAGGTATACT -> GAGGTATACTC
TGATCTTCGGG -> GATCTTCGGGA
TGATGGGATCC -> GATGGGATCCA
TGATGTAATAC -> GATGTAATACG
TGATGTGATGT -> GATGTGATGTA
TGATGTTTGCT -> GATGTTTGCTT
TGATTAGTATA -> GATTAGTATAT
TGATTATGTAT -> GATTATGTATA
TGATTCCGACA -> GATTCCGACAG
TGCAACCCCGA -> GCAACCCCGAC
TGCAATCATAA -> GCAATCATAAT
TGCACATAAAA -> GCACATAAAAG
TGCACCACCAT -> GCACCACCATT
TGCACCCCGTA -> GCACCCCGTAA
TGCATATATCG -> GCATATATCGA
TGCCATCACTA -> GCCATCACTAA
TGCCATCAGGA -> GCCATCAGGAC
TGCCGAAATGT -> GCCGAAATGTC
TGCCGGTAGCT -> GCCGGTAGCTC
TGCCGTCGAAT -> GCCGTCGAATA
TGCCTCCTAAA -> GCCTCCTAAAC
TGCCTTGTATG -> GCCTTGTATGG
TGCGATACAGC -> GCGATACAGCA
TGCGATGGGTG -> GCGATGGGTGC
TGCGATGTATT -> GCGATGTATTA
TGCGGGCTGGG -> GCGGGCTGGGA
TGCGGGTGTTA -> GCGGGTGTTAC
TGCGTAAGATC -> GCGTAAGATCT
TGCGTTCCGCA -> GCGTTCCGCAC
TGCTACCGGTC -> GCTACCGGTCG
TGCTCACGGGT -> GCTCACGGGTC
TGCTCCGGCGG -> GCTCCGGCGGC
TGCTGGGTTGG -> GCTGGGTTGGC
TGCTGTTGTTC -> GCTGTTGTTCT
TGCTTAACATC -> GCTTAACATCT
TGCTTACACGT -> GCTTACACGTG
TGCTTCGGTTT -> GCTTCGGTTTC
TGCTTTTGAAA -> GCTTTTGAAAG
TGGAAGTGTCG -> GGAAGTGTCGG
TGGACAGCCGT -> GGACAGCCGTG
TGGAGGCTGGA -> GGAGGCTGGAT
TGGATCCCCCG -> GGATCCCCCGT
TGGATGCTGGG -> GGATGCTGGGT
TGGATGTATGC -> GGATGTATGCA
TGGATTTACGA -> GGATTTACGAG
TGGCAAGTGGG -> GGCAAGTGGGG
TGGCACCTGCT -> GGCACCTGCTG
TGGCTCTGCCG -> GGCTCTGCCGA
TGGGAATGTGT -> GGGAATGTGTT
TGGGACGTTAG -> GGGACGTTAGA
TGGGATCCACG -> GGGATCCACGC
TGGGCATGAAG -> GGGCATGAAGT
TGGGCATTATC -> GGGCATTATCT
TGGGCTCCGAG -> GGGCTCCGAGT
TGGGGGTTCAG -> GGGGGTTCAGT
TGGGTAATGTA -> GGGTAATGTAG
TGGGTCGCCTG -> GGGTCGCCTGT
TGGGTGCGATG -> GGGTGCGATGT
TGGGTTGGCTC -> GGGTTGGCTCT
TGGTAAGCCAT -> GGTAAGCCATC
TGGTACGTGAC -> GGTACGTGACG
TGGTCTTCTCC -> GGTCTTCTCCG
TGGTGAAATAC -> GGTGAAATACC
TGGTGTGCGAT -> GGTGTGCGATG
TGGTTCGATGA -> GGTTCGATGAA
TGGTTCGGTTG -> GGTTCGGTTGA
TGTAAGGTCTA -> GTAAGGTCTAA
TGTAATACGCG -> GTAATACGCGC
TGTACAATCGG -> GTACAATCGGG
TGTACATCTAA -> GTACATCTAAG
TGTACATTCCT -> GTACATTCCTG
TGTAGACTTAA -> GTAGACTTAAC
TGTAGGTGACA -> GTAGGTGACAG
TGTATACCACA -> GTATACCACAA
TGTATGCAATC -> GTATGCAATCA
TGTATGGTTCG -> GTATGGTTCGA
TGTATTAGTGT -> GTATTAGTGTA
TGTCAGTTGCG -> GTCAGTTGCGG
TGTCCTTGGTG -> GTCCTTGGTGT
TGTCGGGCGCC -> GTCGGGCGCCG
TGTCGTGGGAA -> GTCGTGGGAAT
TGTCGTTCCTC -> GTCGTTCCTCG
TGTCTCCTTGG -> GTCTCCTTGGG
TGTCTGCTCAC -> GTCTGCTCACG
TGTCTGTAAGG -> GTCTGTAAGGT
TGTGACATAAG -> GTGACATAAGT
TGTGACTTCGA -> GTGACTTCGAC
TGTGATCTTCG -> GTGATCTTCGG
TGTGATGGGAT -> GTGATGGGATC
TGTGATGTAAT -> GTGATGTAATA
TGTGATGTGAT -> GTGATGTGATG
TGTGCACCACC -> GTGCACCACCA
TGTGCGATGGG -> GTGCGATGGGT
TGTGCTACCGG -> GTGCTACCGGT
TGTGTTGGGTC -> GTGTTGGGTCG
TGTTAATCGAC -> GTTAATCGACT
TGTTACGTCTG -> GTTACGTCTGG
TGTTACTCTAA -> GTTACTCTAAG
TGTTAGACTGA -> GTTAGACTGAA
TGTTATTTTAA -> GTTATTTTAAA
TGTTCTTTGAC -> GTTCTTTGACT
TGTTGGGTCGC -> GTTGGGTCGCC
TGTTGTTCTTT -> GTTGTTCTTTG
TGTTTGCTTAC -> GTTTGCTTACA
TTAAACCCGGT -> TAAACCCGGTC
TTAAAGCCGGC -> TAAAGCCGGCA
TTAACATCTGT -> TAACATCTGTC
TTAACTCGACT -> TAACTCGACTA
TTAATCGACTG -> TAATCGACTGA
TTAATGTTATT -> TAATGTTATTT
TTACACAGACG -> TACACAGACGC
TTACACGTGTT -> TACACGTGTTA
TTACATCTCCA -> TACATCTCCAA
TTACCGAGCGG -> TACCGAGCGGA
TTACGAGCCTC -> TACGAGCCTCG
TTACGAGGTGT -> TACGAGGTGTC
TTACGGCATGT -> TACGGCATGTC
TTACGTACAAC -> TACGTACAACG
TTACGTCTGGA -> TACGTCTGGAT
TTACTCTAAGC -> TACTCTAAGCC
TTACTCTCAAA -> TACTCTCAAAT
TTAGAATCGAC -> TAGAATCGACT
TTAGACAGATC -> TAGACAGATCC
TTAGACTGAAA -> TAGACTGAAAA
TTAGCAGGCTG -> TAGCAGGCTGG
TTAGGGGAACA -> TAGGGGAACAC
TTAGTATATCA -> TAGTATATCAG
TTAGTCATACT -> TAGTCATACTG
TTAGTGATTAG -> TAGTGATTAGT
TTAGTGTACAT -> TAGTGTACATC
TTATACATTGG -> TATACATTGGC
TTATCTAACGA -> TATCTAACGAT
TTATGTATACC -> TATGTATACCA
TTATTATACAT -> TATTATACATT
TTATTGTGACA -> TATTGTGACAT
TTATTTTAAAC -> TATTTTAAACC
TTCAACAACCA -> TCAACAACCAG
TTCACATAAAA -> TCACATAAAAC
TTCAGATCCGA -> TCAGATCCGAG
TTCAGTCGCTT -> TCAGTCGCTTT
TTCATCGTGCT -> TCATCGTGCTC
TTCCAACTGCG -> TCCAACTGCGT
TTCCCATGAAA -> TCCCATGAAAG
TTCCGACAGCA -> TCCGACAGCAA
TTCCGCACTTC -> TCCGCACTTCC
TTCCGTTAGTC -> TCCGTTAGTCA
TTCCTCGTCGA -> TCCTCGTCGAT
TTCCTCTTCGT -> TCCTCTTCGTT
TTCCTGTGATC -> TCCTGTGATCT
TTCGAAAATCA -> TCGAAAATCAA
TTCGACACGTG -> TCGACACGTGG
TTCGACTAGGG -> TCGACTAGGGA
TTCGACTGGAT -> TCGACTGGATT
TTCGATGAAAG -> TCGATGAAAGG
TTCGATTCTGC -> TCGATTCTGCA
TTCGCCGAGAA -> TCGCCGAGAAC
TTCGGGAGTAT -> TCGGGAGTATC
TTCGGGTGCTT -> TCGGGTGCTTC
TTCGGTTGAGC -> TCGGTTGAGCC
TTCGGTTTCGA -> TCGGTTTCGAC
TTCGTGCCTCC -> TCGTGCCTCCT
TTCGTTGAGGC -> TCGTTGAGGCC
TTCTAAGACAA -> TCTAAGACAAA
TTCTCATCTTA -> TCTCATCTTAG
TTCTCCGCGTT -> TCTCCGCGTTG
TTCTGCACCCC -> TCTGCACCCCG
TTCTGCATATA -> TCTGCATATAT
TTCTTTGACTC -> TCTTTGACTCT
TTGAAAGTCCC -> TGAAAGTCCCC
TTGACTCTTCA -> TGACTCTTCAG
TTGAGCCTTAC -> TGAGCCTTACC
TTGAGGCCAAT -> TGAGGCCAATG
TTGATTCCGAC -> TGATTCCGACA
TTGCGGGTGTT -> TGCGGGTGTTA
TTGCTTACACG -> TGCTTACACGT
TTGCTTTTGAA -> TGCTTTTGAAA
TTGGCACCTGC -> TGGCACCTGCT
TTGGCTCTGCC -> TGGCTCTGCCG
TTGGGCTCCGA -> TGGGCTCCGAG
TTGGGTCGCCT -> TGGGTCGCCTG
TTGGTGAAATA -> TGGTGAAATAC
TTGGTGTGCGA -> TGGTGTGCGAT
TTGTACATTCC -> TGTACATTCCT
TTGTATGGTTC -> TGTATGGTTCG
TTGTCGTGGGA -> TGTCGTGGGAA
TTGTGACATAA -> TGTGACATAAG
TTGTGACTTCG -> TGTGACTTCGA
TTGTGCTACCG -> TGTGCTACCGG
TTGTTACGTCT -> TGTTACGTCTG
TTGTTCTTTGA -> TGTTCTTTGAC
TTTAAACCCGG -> TTAAACCCGGT
TTTAATGTTAT -> TTAATGTTATT
TTTACACAGAC -> TTACACAGACG
TTTACGAGGTG -> TTACGAGGTGT
TTTCATCGTGC -> TTCATCGTGCT
TTTCCAACTGC -> TTCCAACTGCG
TTTCCGTTAGT -> TTCCGTTAGTC
TTTCGACACGT -> TTCGACACGTG
TTTCGCCGAGA -> TTCGCCGAGAA
TTTCTAAGACA -> TTCTAAGACAA
TTTGAAAGTCC -> TTGAAAGTCCC
TTTGACTCTTC -> TTGACTCTTCA
TTTGCTTACAC -> TTGCTTACACG
TTTTAAACCCG -> TTTAAACCCGG
TTTTAATGTTA -> TTTAATGTTAT
TTTTCGCCGAG -> TTTCGCCGAGA
TTTTCTAAGAC -> TTTCTAAGACA
TTTTGAAAGTC -> TTTGAAAGTCC
TTTTTAATGTT -> TTTTAATGTTA
TTTTTTAATGT -> TTTTTAATGTT
